Date,Home,Away,Unique_Devices,Starts,Live_Unique_Devices,Live_Starts,VOD_Unique_Devices,VOD_Starts,Life_Play_Time
2018-06-08,CLE,GSW,5335,8665,168,250,5168,8415,200104.79
2018-06-06,CLE,GSW,7500,13635,233,447,7269,13188,298438.69
2018-06-03,GSW,CLE,8383,15735,250,586,8134,15149,376006.04
2018-05-31,GSW,CLE,9368,19695,371,792,9002,18903,452445.88
2018-05-28,HOU,GSW,214913,957161,208990,943446,6780,13715,10396860.41
2018-05-27,BOS,CLE,7095,13362,270,544,6827,12818,302333.21
2018-05-26,GSW,HOU,149576,576937,143387,564494,6949,12443,5861217.31
2018-05-25,CLE,BOS,6343,11197,230,412,6116,10785,270750.03
2018-05-24,HOU,GSW,146929,570093,142245,561385,5248,8708,6093142.25
2018-05-23,BOS,CLE,5195,8874,179,407,5017,8467,206872.5
2018-05-22,GSW,HOU,139079,540385,133524,529354,6239,11031,7090296.01
2018-05-21,CLE,BOS,4766,8747,186,364,4582,8383,222766.71
2018-05-20,GSW,HOU,103235,348473,97618,335216,6223,13257,3743094.38
2018-05-19,CLE,BOS,10574,17390,223,392,10353,16998,310443.42
2018-05-16,HOU,GSW,122761,430633,116704,418909,6724,11724,4893017.01
2018-05-15,BOS,CLE,7456,13351,277,590,7181,12761,342055.1
2018-05-14,HOU,GSW,145431,570372,138613,555827,7701,14545,6002501.92
2018-05-13,BOS,CLE,10216,16897,284,664,9935,16233,335243.14
2018-05-09,BOS,PHI,98699,307352,94079,299044,5167,8308,3866979.66
2018-05-08,GSW,NOP,59008,168842,54363,160040,5039,8802,2328093.59
2018-05-08,HOU,UTA,64632,179006,61353,173336,3593,5670,2955342.29
2018-05-07,CLE,TOR,83275,255071,79014,246943,4778,8128,4607398.55
2018-05-07,PHI,BOS,59076,167832,55917,163131,3434,4701,2702433.05
2018-05-06,NOP,GSW,6271,11202,232,560,6041,10642,254871.95
2018-05-06,UTA,HOU,56131,175433,53821,171659,2528,3774,1928861.61
2018-05-05,CLE,TOR,6955,12212,219,467,6737,11745,279538.15
2018-05-05,PHI,BOS,5852,9867,252,707,5600,9160,238745.74
2018-05-04,NOP,GSW,5343,8949,197,392,5146,8557,177210.25
2018-05-04,UTA,HOU,3088,4465,116,171,2973,4294,85875.38
2018-05-03,BOS,PHI,71036,191954,66887,185021,4553,6933,2568372.08
2018-05-03,TOR,CLE,7633,14117,238,479,7398,13638,328139.32
2018-05-02,HOU,UTA,73971,205583,69513,197779,4886,7804,2695522.82
2018-05-01,GSW,NOP,60025,168580,54265,157693,6172,10887,2336788.79
2018-05-01,TOR,CLE,118024,422337,112751,411496,5956,10841,5686166.68
2018-04-30,BOS,PHI,70710,209480,66449,202042,4660,7438,2696701.32
2018-04-29,CLE,IND,8057,14020,263,641,7795,13379,348018.75
2018-04-29,HOU,UTA,4751,7048,137,268,4614,6780,137303.27
2018-04-28,BOS,MIL,62317,187417,59039,182156,3591,5261,2478509.73
2018-04-28,GSW,NOP,59826,171358,53955,160874,6365,10484,2062361.34
2018-04-27,IND,CLE,4369,7185,154,339,4215,6846,122958.51
2018-04-27,UTA,OKC,5343,8820,212,433,5131,8387,180570.39
2018-04-27,WAS,TOR,2448,3406,86,122,2362,3284,65098.86
2018-04-26,MIL,BOS,50989,137983,48010,133464,3216,4519,2094434.17
2018-04-25,CLE,IND,91947,309380,86738,299462,5840,9918,3670578.3
2018-04-25,HOU,MIN,46756,118869,44700,115781,2261,3088,1808866.98
2018-04-25,OKC,UTA,6212,10359,246,387,5970,9972,232577.0
2018-04-25,TOR,WAS,2436,3316,86,118,2351,3198,59660.14
2018-04-24,BOS,MIL,3948,6289,209,407,3743,5882,176639.33
2018-04-24,GSW,SAS,19522,38924,15990,33444,3592,5480,418908.66
2018-04-24,PHI,MIA,64678,191445,61841,186886,3131,4559,2895753.23
2018-04-23,MIN,HOU,60704,180811,57820,175801,3190,5010,4214503.16
2018-04-23,UTA,OKC,53881,162825,49600,155281,4596,7544,3936588.68
2018-04-22,IND,CLE,77272,257276,73229,249438,4452,7838,5294661.02
2018-04-22,MIL,BOS,4439,6535,166,669,4274,5866,117932.48
2018-04-22,SAS,GSW,4059,5952,159,331,3901,5621,111301.47
2018-04-22,WAS,TOR,45355,128338,43243,125105,2298,3233,2902028.62
2018-04-21,MIA,PHI,47186,146277,42841,139041,4642,7236,1972781.26
2018-04-21,MIN,HOU,3671,5627,140,367,3531,5260,114426.35
2018-04-21,NOP,POR,37644,101449,35408,97648,2354,3801,1267562.29
2018-04-21,UTA,OKC,3888,6162,146,254,3742,5908,141397.79
2018-04-20,IND,CLE,5994,11018,230,473,5764,10545,203479.73
2018-04-20,MIL,BOS,2244,3087,117,166,2128,2921,64316.78
2018-04-20,WAS,TOR,2163,3091,81,214,2082,2877,65509.25
2018-04-19,MIA,PHI,61364,195759,57413,188768,4317,6991,2855879.02
2018-04-19,NOP,POR,3669,5261,155,318,3518,4943,112557.58
2018-04-19,SAS,GSW,43087,115649,39566,109353,3814,6296,2073198.52
2018-04-18,CLE,IND,83672,295491,78513,286167,5743,9324,3143753.14
2018-04-18,HOU,MIN,41079,105607,38509,101646,2764,3961,1645802.97
2018-04-18,OKC,UTA,5894,9870,271,639,5627,9231,227972.44
2018-04-17,BOS,MIL,46667,132171,43597,127132,3331,5039,1929559.95
2018-04-17,POR,NOP,35529,92995,32174,87624,3547,5371,1243612.81
2018-04-17,TOR,WAS,2805,3949,119,281,2686,3668,75716.25
2018-04-16,GSW,SAS,47617,148753,42848,139739,5135,9014,2572152.78
2018-04-16,PHI,MIA,64936,219618,61184,213013,4116,6605,2621054.6
2018-04-15,BOS,MIL,63819,218434,59346,210732,4860,7702,1930649.31
2018-04-15,CLE,IND,5032,8100,196,316,4837,7784,166260.61
2018-04-15,HOU,MIN,53891,177381,50422,171381,3722,6000,1647905.36
2018-04-15,OKC,UTA,55651,196024,51871,189094,4148,6930,2049749.73
2018-04-14,GSW,SAS,7542,13198,311,1112,7232,12086,295954.05
2018-04-14,PHI,MIA,4280,7020,188,399,4093,6621,153848.62
2018-04-14,POR,NOP,4364,6745,180,413,4184,6332,133314.69
2018-04-14,TOR,WAS,3162,4718,124,230,3038,4488,101416.43
2018-04-11,BOS,BRK,7049,16144,5959,14367,1225,1777,208799.99
2018-04-11,CHI,DET,2310,4498,1891,3843,463,655,63257.23
2018-04-11,CLE,NYK,21928,52029,20162,49025,2063,3004,706188.42
2018-04-11,LAC,LAL,11848,24483,10837,22609,1186,1874,508550.06
2018-04-11,MIA,TOR,14877,41430,13844,39426,1266,2004,482860.57
2018-04-11,MIN,DEN,63512,204566,61217,199822,2815,4744,2831260.93
2018-04-11,NOP,SAS,10420,25418,9519,23935,996,1483,339902.34
2018-04-11,OKC,MEM,15342,44885,13940,42082,1675,2803,509218.9
2018-04-11,ORL,WAS,4021,9215,3673,8705,374,510,116259.46
2018-04-11,PHI,MIL,1323,2076,84,119,1239,1957,44965.94
2018-04-11,POR,UTA,1051,1706,64,112,987,1594,40051.1
2018-04-11,SAC,HOU,7094,13565,6449,12507,722,1058,274897.56
2018-04-10,ATL,PHI,17788,41961,16393,39682,1628,2279,650634.47
2018-04-10,DAL,PHX,3474,6598,3057,5955,458,643,79945.06
2018-04-10,IND,CHA,5558,10561,4970,9743,635,818,137870.19
2018-04-10,LAL,HOU,13218,35829,11426,32783,1898,3046,324491.1
2018-04-10,UTA,GSW,28755,65792,26268,61372,2937,4420,1115231.38
2018-04-10,WAS,BOS,12396,32557,11396,31049,1060,1508,366516.83
2018-04-09,BRK,CHI,3106,6511,2635,5814,516,697,89883.92
2018-04-09,DEN,POR,25222,58199,24063,56141,1353,2058,1244435.12
2018-04-09,DET,TOR,7379,13742,6602,12611,850,1131,187258.42
2018-04-09,LAC,NOP,584,821,32,41,553,780,15135.07
2018-04-09,MIA,OKC,31581,86712,29541,82493,2509,4219,1297490.24
2018-04-09,MIL,ORL,4799,9078,4253,8274,581,804,462876.72
2018-04-09,MIN,MEM,8439,18114,7703,16937,832,1177,246841.72
2018-04-09,NYK,CLE,3447,6529,154,323,3293,6206,164643.31
2018-04-09,SAS,SAC,14246,31611,13303,29543,1228,2068,534294.37
2018-04-08,BOS,ATL,11494,23750,9800,21094,1860,2656,449964.0
2018-04-08,CHA,IND,5595,10446,4443,8778,1231,1668,174970.44
2018-04-08,LAL,UTA,18740,40019,16677,36278,2421,3741,874197.47
2018-04-08,MEM,DET,478,595,19,25,459,570,10005.98
2018-04-08,PHI,DAL,2484,3531,105,158,2381,3373,73258.85
2018-04-08,PHX,GSW,2457,4548,169,607,2288,3941,113240.96
2018-04-08,TOR,ORL,529,710,27,31,502,679,12520.13
2018-04-07,CHI,BRK,2923,5623,2425,4832,541,791,90180.99
2018-04-07,GSW,NOP,25606,60852,22202,54973,3810,5879,1040318.84
2018-04-07,HOU,OKC,4904,9383,192,563,4714,8820,231567.01
2018-04-07,LAC,DEN,1103,1524,53,88,1050,1436,29235.28
2018-04-07,NYK,MIL,8946,17009,7964,15535,1082,1474,334357.25
2018-04-07,SAS,POR,17348,36444,15308,32572,2375,3872,609718.51
2018-04-06,BOS,CHI,12347,27792,10353,24086,2323,3706,453937.36
2018-04-06,DET,DAL,4240,7896,3525,6861,782,1035,100159.68
2018-04-06,LAL,MIN,1622,2544,73,115,1549,2429,60888.22
2018-04-06,MEM,SAC,4399,7799,3839,6939,624,860,112840.85
2018-04-06,NYK,MIA,6348,14397,5365,12696,1113,1701,234292.77
2018-04-06,ORL,CHA,1788,3183,1341,2615,465,568,35267.89
2018-04-06,PHI,CLE,8939,15934,456,828,8485,15106,438036.17
2018-04-06,PHX,NOP,6746,13540,6205,12754,602,786,269835.85
2018-04-06,TOR,IND,6437,12843,5592,11558,929,1285,215286.73
2018-04-06,WAS,ATL,3805,7030,3257,6310,581,720,93300.16
2018-04-05,CLE,WAS,28700,92449,24708,84428,4383,8021,931415.29
2018-04-05,DEN,MIN,9627,24845,8651,23435,1021,1410,238384.57
2018-04-05,HOU,POR,17308,36411,14336,31265,3345,5146,561945.25
2018-04-05,IND,GSW,22906,48942,20024,44268,3194,4674,914234.04
2018-04-05,MIL,BRK,5890,12770,5170,11591,791,1179,179249.82
2018-04-05,UTA,LAC,9556,21929,8470,19834,1281,2095,432233.39
2018-04-04,ATL,MIA,6087,12941,5301,11458,928,1483,207000.93
2018-04-04,DET,PHI,15645,34037,13567,30832,2312,3205,672262.7
2018-04-04,LAL,SAS,2342,4055,107,195,2235,3860,98262.7
2018-04-04,NOP,MEM,4783,8619,4194,7794,640,825,136854.43
2018-04-04,ORL,DAL,3903,7665,3450,7008,495,657,95109.71
2018-04-04,TOR,BOS,1457,2219,73,131,1384,2088,47975.65
2018-04-03,CHI,CHA,2772,5560,2273,4755,531,805,77024.32
2018-04-03,CLE,TOR,45161,131232,40218,120390,6169,10842,2277351.78
2018-04-03,DAL,POR,6230,13252,5503,12096,790,1156,192640.51
2018-04-03,DEN,IND,7854,17216,7158,16071,792,1145,324991.23
2018-04-03,HOU,WAS,9247,19686,7602,16804,1837,2882,331163.74
2018-04-03,LAC,SAS,8438,24761,7574,23458,901,1303,243082.32
2018-04-03,MIA,ATL,8114,19155,7295,17625,987,1530,258421.84
2018-04-03,MIL,BOS,22950,55160,21132,52222,2046,2938,971027.72
2018-04-03,NYK,ORL,3192,6375,2771,5738,451,637,99164.55
2018-04-03,OKC,GSW,36466,143634,32095,134616,4755,9018,1121715.79
2018-04-03,PHI,BRK,9186,21466,7967,19509,1398,1957,361952.93
2018-04-03,PHX,SAC,3979,8405,3589,7756,429,649,135715.48
2018-04-03,UTA,LAL,16526,37678,15088,34865,1716,2813,731182.28
2018-04-01,ATL,ORL,1926,3751,1621,3312,322,439,45454.78
2018-04-01,BRK,DET,3789,8184,3281,7442,558,742,130636.46
2018-04-01,CHA,PHI,2342,3493,94,149,2249,3344,75587.42
2018-04-01,CHI,WAS,5099,9863,4141,8527,1008,1336,155858.91
2018-04-01,CLE,DAL,27583,70112,24205,63141,4142,6971,1312346.34
2018-04-01,DEN,MIL,16625,37600,15267,35053,1626,2547,677915.64
2018-04-01,GSW,PHX,19514,43095,16976,38142,3038,4953,1160068.59
2018-04-01,LAC,IND,6424,13197,5539,11850,973,1347,218313.14
2018-04-01,LAL,SAC,1363,2058,72,93,1291,1965,55729.47
2018-04-01,MIN,UTA,12638,27845,11007,24589,1925,3256,560985.71
2018-04-01,NOP,OKC,2834,4758,111,133,2723,4625,117847.8
2018-04-01,POR,MEM,6979,13972,6372,12996,708,976,246046.77
2018-04-01,SAS,HOU,3250,5273,122,188,3128,5085,131309.27
2018-03-31,BOS,TOR,4233,7668,199,314,4039,7354,225691.57
2018-03-31,MIA,BRK,11334,26338,10326,24735,1142,1603,469414.69
2018-03-31,NYK,DET,6731,13172,5654,11477,1180,1695,260719.66
2018-03-31,SAC,GSW,19940,45502,17456,40066,3008,5436,1196641.06
2018-03-31,WAS,CHA,1104,1489,49,67,1055,1422,27841.36
2018-03-30,ATL,PHI,10669,23799,9272,21365,1613,2434,403923.33
2018-03-30,CLE,NOP,4469,8214,174,319,4296,7895,209312.86
2018-03-30,DAL,MIN,5259,10121,4227,8602,1117,1519,152607.37
2018-03-30,HOU,PHX,12958,27962,10354,23242,3047,4720,437987.77
2018-03-30,LAL,MIL,20018,46130,18134,42556,2222,3574,999392.25
2018-03-30,OKC,DEN,24605,59805,22354,56117,2547,3688,842363.19
2018-03-30,ORL,CHI,4318,7948,3740,7038,637,910,121590.11
2018-03-30,POR,LAC,829,1189,30,36,799,1153,26735.63
2018-03-30,UTA,MEM,7033,14916,6142,13136,1065,1780,298693.44
2018-03-29,DET,WAS,9218,18186,8192,16711,1156,1475,300964.48
2018-03-29,GSW,MIL,14061,33669,11520,29682,2658,3987,404157.75
2018-03-29,MIA,CHI,10281,22835,9177,20874,1279,1961,419802.62
2018-03-29,SAC,IND,6779,14043,5972,12800,908,1243,286888.95
2018-03-29,SAS,OKC,20000,57344,17572,53199,2589,4145,763146.51
2018-03-28,CHA,CLE,4804,9219,182,315,4624,8904,254183.73
2018-03-28,LAL,DAL,16308,38987,14688,35577,2017,3410,845540.87
2018-03-28,MEM,POR,12063,24113,11222,22918,918,1195,367005.7
2018-03-28,MIN,ATL,7080,13395,6029,11716,1143,1679,234604.59
2018-03-28,ORL,BRK,3639,7658,3179,6965,515,693,98997.3
2018-03-28,PHI,NYK,18259,39531,16572,36544,1950,2987,924775.1
2018-03-28,PHX,LAC,4715,9241,4298,8624,460,617,148514.49
2018-03-28,UTA,BOS,3253,5592,142,307,3111,5285,120579.13
2018-03-27,GSW,IND,19791,46055,18015,42911,2069,3144,1034831.11
2018-03-27,HOU,CHI,9642,20162,8008,17486,1835,2676,316612.12
2018-03-27,LAC,MIL,625,820,33,46,592,774,16676.84
2018-03-27,MIA,CLE,28442,95007,26104,90831,2546,4176,963439.71
2018-03-27,NOP,POR,16354,35601,14382,32259,2212,3342,493899.99
2018-03-27,SAC,DAL,4990,9717,4519,8896,528,821,232098.63
2018-03-27,TOR,DEN,12063,25585,10998,23976,1178,1609,401128.45
2018-03-27,WAS,SAS,12658,26067,11412,24236,1368,1831,463253.36
2018-03-26,CHA,NYK,9415,18619,7954,16327,1597,2292,290389.07
2018-03-26,DET,LAL,22451,52516,20113,48284,2648,4232,922758.27
2018-03-26,MIN,MEM,12253,22368,11475,21241,842,1127,453570.71
2018-03-26,PHI,DEN,3056,5186,145,231,2914,4955,147941.96
2018-03-26,PHX,BOS,1984,3228,106,169,1879,3059,82797.35
2018-03-25,BRK,CLE,5966,11147,254,414,5716,10733,292644.74
2018-03-25,GSW,UTA,2769,4442,153,265,2617,4177,106971.7
2018-03-25,HOU,ATL,11757,23179,10509,21013,1469,2166,439929.88
2018-03-25,IND,MIA,12258,29273,11129,27416,1287,1857,504727.8
2018-03-25,MIL,SAS,16702,35418,14643,32252,2259,3166,910918.19
2018-03-25,OKC,POR,32911,81181,29585,74803,3851,6378,1536398.56
2018-03-25,SAC,BOS,13867,31680,11919,27923,2282,3757,568635.96
2018-03-25,TOR,LAC,8046,15217,7111,13832,1023,1385,250155.14
2018-03-25,WAS,NYK,942,1529,41,62,901,1467,37960.96
2018-03-24,DAL,CHA,5661,10794,5113,10010,605,784,160699.45
2018-03-24,DET,CHI,4391,8091,3588,6900,874,1191,123779.17
2018-03-24,HOU,NOP,2354,3578,111,201,2245,3377,82034.25
2018-03-24,MEM,LAL,16170,39569,13951,35034,2607,4535,738442.21
2018-03-24,ORL,PHX,4158,8854,3686,8175,509,679,109912.38
2018-03-24,PHI,MIN,17032,35740,14175,30931,3185,4809,904610.44
2018-03-23,CHI,MIL,4542,9212,3844,8196,751,1016,138005.91
2018-03-23,CLE,PHX,24940,64390,21084,55835,4844,8555,1270297.66
2018-03-23,GSW,ATL,21571,48051,18912,42980,3176,5071,1119177.38
2018-03-23,IND,LAC,7730,15507,6788,14109,1017,1398,251234.46
2018-03-23,NYK,MIN,6633,13783,5500,11897,1275,1886,294700.12
2018-03-23,OKC,MIA,21418,51737,19361,47791,2459,3946,837519.48
2018-03-23,POR,BOS,4001,6601,208,354,3795,6247,170354.32
2018-03-23,SAS,UTA,21476,52970,19224,48324,2744,4646,1114361.48
2018-03-23,TOR,BRK,6192,13101,5550,12122,705,979,225871.82
2018-03-23,WAS,DEN,846,1239,38,61,808,1178,26344.08
2018-03-22,CHA,MEM,6088,11813,4904,10225,1234,1588,131980.91
2018-03-22,DAL,UTA,9280,19495,8244,17588,1212,1907,382624.09
2018-03-22,HOU,DET,21460,47127,19171,43194,2672,3933,784940.91
2018-03-22,NOP,LAL,23875,58019,21571,53989,2626,4030,983586.73
2018-03-22,ORL,PHI,1183,1875,49,184,1135,1691,37170.74
2018-03-22,SAC,ATL,6112,11290,5644,10358,524,932,251536.74
2018-03-21,BRK,CHA,4418,9024,3718,7914,752,1110,113823.2
2018-03-21,CHI,DEN,3719,7302,3065,6351,708,951,111818.2
2018-03-21,CLE,TOR,7190,14311,303,593,6890,13718,377762.05
2018-03-21,MIA,NYK,7569,15909,6537,14133,1205,1776,370004.78
2018-03-21,MIL,LAC,7012,13533,6109,12218,957,1315,207932.78
2018-03-21,NOP,IND,14098,31621,13164,30200,1066,1421,507860.33
2018-03-21,PHI,MEM,9560,19697,8296,17619,1437,2078,396777.72
2018-03-21,SAS,WAS,1130,1665,50,70,1080,1595,38144.01
2018-03-20,BOS,OKC,28914,84761,24466,76877,4799,7884,980227.43
2018-03-20,MIN,LAC,9141,19610,8021,17742,1240,1868,375410.92
2018-03-20,NOP,DAL,7000,14925,6263,13824,811,1101,210763.21
2018-03-20,ORL,TOR,9497,18594,8645,17322,942,1272,329010.72
2018-03-20,PHX,DET,5158,10191,4580,9242,649,949,209670.42
2018-03-20,POR,HOU,22705,68140,19324,62164,3611,5976,1140296.41
2018-03-20,UTA,ATL,11270,25728,10552,24498,834,1230,490619.14
2018-03-19,BRK,MEM,3527,7138,3143,6569,419,569,94788.05
2018-03-19,CLE,MIL,4997,11028,190,579,4808,10449,234615.33
2018-03-19,IND,LAL,17747,43282,15693,39667,2269,3615,1168042.97
2018-03-19,MIA,DEN,18074,47840,17078,45668,1214,2172,826125.26
2018-03-19,NYK,CHI,5935,11603,5021,10141,1018,1462,263330.56
2018-03-19,PHI,CHA,10237,22569,8909,20169,1547,2400,479097.75
2018-03-19,SAC,DET,6121,12258,5652,11467,551,791,249859.46
2018-03-19,SAS,GSW,2455,4019,119,167,2337,3852,82568.93
2018-03-18,LAC,POR,1172,1761,67,109,1105,1652,47450.05
2018-03-18,MIN,HOU,2960,4799,136,207,2824,4592,133041.07
2018-03-18,NOP,BOS,21113,43405,18772,39826,2598,3579,885907.9
2018-03-18,TOR,OKC,30075,78280,23951,65433,7017,12847,1453246.97
2018-03-17,BRK,DAL,2862,5941,2426,5221,490,720,75975.27
2018-03-17,CHI,CLE,25377,65187,21924,58010,4169,7177,1101283.79
2018-03-17,MEM,DEN,4681,9891,4320,9382,394,509,115910.74
2018-03-17,MIL,ATL,6698,13126,5885,11894,885,1232,205466.49
2018-03-17,NOP,HOU,16412,36529,13962,32348,2749,4181,675462.86
2018-03-17,NYK,CHA,3544,7303,2713,5692,954,1611,155831.86
2018-03-17,PHX,GSW,17747,37013,14911,31491,3372,5522,1019559.36
2018-03-17,POR,DET,7202,15227,6288,13712,1034,1515,305583.54
2018-03-17,SAS,MIN,1781,2926,69,120,1712,2806,84743.92
2018-03-17,UTA,SAC,9683,22788,8700,20603,1223,2185,446506.22
2018-03-17,WAS,IND,4901,9688,4004,8382,960,1306,169772.34
2018-03-16,GSW,SAC,35852,80340,33169,75706,3149,4634,1428946.92
2018-03-16,LAL,MIA,2975,4795,142,186,2835,4609,127511.05
2018-03-16,OKC,LAC,2501,4235,93,163,2408,4072,112163.53
2018-03-16,ORL,BOS,19383,38070,16428,33476,3288,4594,667508.73
2018-03-16,PHI,BRK,18189,39872,16521,36995,1906,2877,538813.5
2018-03-16,TOR,DAL,22415,47353,21116,45238,1511,2115,611744.81
2018-03-15,ATL,CHA,4579,8600,4061,7866,545,734,78956.5
2018-03-15,DEN,DET,7950,15522,7258,14350,770,1172,180027.25
2018-03-15,HOU,LAC,2653,4407,111,165,2542,4242,98486.81
2018-03-15,IND,TOR,28622,62723,26721,59659,2153,3064,770841.9
2018-03-15,MEM,CHI,8699,15946,7682,14409,1116,1537,168351.91
2018-03-15,NYK,PHI,18495,40272,17000,37567,1730,2705,593496.57
2018-03-15,POR,CLE,67605,177921,63220,169215,5296,8706,2983482.86
2018-03-15,SAS,NOP,23994,53722,22293,50544,1992,3178,740601.95
2018-03-15,UTA,PHX,12265,29621,10866,26442,1738,3179,448689.86
2018-03-14,BOS,WAS,3413,5346,139,210,3274,5136,129716.15
2018-03-14,GSW,LAL,4781,8509,218,772,4563,7737,187002.28
2018-03-14,ORL,MIL,17582,34136,15819,31559,1912,2577,607050.92
2018-03-14,SAC,MIA,16917,39794,15767,37792,1319,2002,698458.16
2018-03-13,ATL,OKC,17350,41507,15469,37925,2172,3582,705879.37
2018-03-13,BRK,TOR,8708,18775,7857,17421,947,1354,226822.2
2018-03-13,CHI,LAC,5701,11127,5069,10177,678,950,151157.03
2018-03-13,LAL,DEN,3367,6301,164,302,3203,5999,155685.16
2018-03-13,NOP,CHA,10904,19814,10067,18596,897,1218,239944.33
2018-03-13,NYK,DAL,5128,10980,4395,9804,807,1176,208135.76
2018-03-13,PHI,IND,21736,50763,19739,47536,2230,3227,1078327.68
2018-03-13,PHX,CLE,31094,75497,27884,68263,4040,7234,1621967.96
2018-03-13,SAS,ORL,6380,13217,5518,11725,992,1492,237734.11
2018-03-13,UTA,DET,9421,20712,8323,18651,1325,2061,415692.43
2018-03-13,WAS,MIN,1880,2929,70,130,1810,2799,71375.38
2018-03-12,HOU,SAS,2467,3816,91,124,2376,3692,92021.26
2018-03-12,MEM,MIL,8372,17476,7271,15833,1189,1643,275051.21
2018-03-12,OKC,SAC,18857,43068,16782,39390,2415,3678,754219.37
2018-03-12,POR,MIA,1433,2136,71,95,1363,2041,44458.22
2018-03-11,ATL,CHI,4987,9761,4100,8396,959,1365,173548.05
2018-03-11,BOS,IND,26682,64125,24347,60211,2685,3914,1167477.61
2018-03-11,BRK,PHI,9243,20549,8218,18829,1187,1720,420527.32
2018-03-11,DAL,HOU,14718,30676,13398,28412,1515,2264,544955.86
2018-03-11,DEN,SAC,5822,10209,5183,9213,685,996,216133.42
2018-03-11,LAL,CLE,4811,8832,216,401,4597,8431,206873.68
2018-03-11,MIN,GSW,4946,7819,223,366,4723,7453,182161.96
2018-03-11,NOP,UTA,13336,28472,11359,24608,2305,3864,506174.99
2018-03-11,NYK,TOR,9212,17380,7775,15185,1576,2195,368509.68
2018-03-10,CHA,PHX,6819,11912,5962,10668,920,1244,202552.94
2018-03-10,DAL,MEM,4103,7412,3547,6570,602,842,119032.92
2018-03-10,LAC,ORL,7127,14195,6596,13250,599,945,344880.2
2018-03-10,MIA,WAS,13634,28688,12122,25861,1763,2827,614719.68
2018-03-10,OKC,SAS,2731,4529,114,145,2617,4384,108870.44
2018-03-09,DEN,LAL,26355,75155,24399,71340,2367,3815,1191866.86
2018-03-09,DET,CHI,7530,14009,6551,12458,1073,1551,228769.03
2018-03-09,IND,ATL,3884,7286,3323,6395,611,891,120723.15
2018-03-09,LAC,CLE,2813,4517,137,271,2679,4246,116362.95
2018-03-09,MEM,UTA,7280,16216,6458,14666,969,1550,260841.27
2018-03-09,MIL,NYK,9224,18467,8257,16872,1093,1595,321269.39
2018-03-09,NOP,WAS,794,1086,24,37,770,1049,17813.02
2018-03-09,POR,GSW,39515,96751,35550,89175,4683,7576,2405584.62
2018-03-09,SAC,ORL,2990,6135,2576,5437,460,698,84258.49
2018-03-09,TOR,HOU,50222,127993,45747,119886,5110,8107,1997421.19
2018-03-08,CHA,BRK,6113,12364,5419,11264,766,1100,193038.31
2018-03-08,GSW,SAS,24058,82672,19669,74202,4636,8470,769335.89
2018-03-08,MIA,PHI,23030,54742,20944,50774,2441,3968,1050191.37
2018-03-08,MIN,BOS,22989,75970,20283,71066,2931,4904,690255.02
2018-03-08,OKC,PHX,14247,32716,12546,29519,2015,3197,549517.66
2018-03-07,CHI,MEM,6112,12540,5393,11311,799,1229,197114.47
2018-03-07,DEN,CLE,4766,9148,171,241,4596,8907,199401.04
2018-03-07,DET,TOR,1622,2556,69,115,1553,2441,53544.82
2018-03-07,IND,UTA,14882,30438,13270,27397,1899,3041,693642.0
2018-03-07,LAL,ORL,22431,61331,19927,55882,3136,5449,1208377.5
2018-03-07,MIL,HOU,29545,67143,27131,62821,2818,4322,1337287.06
2018-03-07,SAC,NOP,7955,14798,7217,13733,819,1065,260353.17
2018-03-06,CHA,PHI,14068,29017,12299,26170,2004,2847,554341.51
2018-03-06,DAL,DEN,7887,15967,7295,14996,663,971,281743.74
2018-03-06,GSW,BRK,23773,54752,20729,47749,3878,7003,2220700.7
2018-03-06,LAC,NOP,1075,1503,44,61,1031,1442,30653.5
2018-03-06,OKC,HOU,31581,96590,28374,91028,3436,5562,1086661.52
2018-03-06,POR,NYK,9460,19080,8480,17256,1127,1824,431587.2
2018-03-06,TOR,ATL,5628,11174,4966,9992,711,1182,160997.22
2018-03-06,WAS,MIA,17464,40848,16352,38981,1269,1867,645868.52
2018-03-05,CHI,BOS,19660,37642,17461,33915,2540,3727,852655.18
2018-03-05,CLE,DET,5662,10554,214,347,5454,10207,264331.39
2018-03-05,IND,MIL,19369,36741,17842,34429,1724,2312,940492.36
2018-03-05,LAL,POR,3454,5627,206,301,3249,5326,140653.59
2018-03-05,MIA,PHX,11025,23032,9994,21332,1197,1700,509521.07
2018-03-05,SAS,MEM,13031,24198,11856,22217,1374,1981,489248.49
2018-03-05,UTA,ORL,12552,24380,11657,22659,1091,1721,529503.57
2018-03-04,ATL,PHX,10513,20142,9394,18457,1224,1685,445498.64
2018-03-04,DAL,NOP,9549,18334,8574,16912,1083,1422,405430.45
2018-03-04,LAC,BRK,7448,16379,6914,15492,609,887,219468.61
2018-03-04,MIL,PHI,1806,3054,88,126,1719,2928,88280.18
2018-03-04,SAC,NYK,8423,17670,7632,16362,883,1308,328571.2
2018-03-04,TOR,CHA,10114,19896,9262,18622,946,1274,349500.62
2018-03-04,WAS,IND,12148,23892,10969,22105,1315,1787,453297.84
2018-03-03,CLE,DEN,37507,93418,33860,87026,4212,6392,1661629.84
2018-03-03,HOU,BOS,6381,10793,295,466,6089,10327,310709.26
2018-03-03,MIA,DET,10452,24207,9157,21926,1487,2281,427676.2
2018-03-03,ORL,MEM,6277,11625,5701,10836,611,789,146539.91
2018-03-03,POR,OKC,23584,52359,21120,48107,2816,4252,1043162.99
2018-03-03,SAC,UTA,6760,14697,5769,12903,1161,1794,304468.7
2018-03-03,SAS,LAL,29620,72476,24798,61776,6165,10700,1362624.09
2018-03-02,ATL,GSW,27965,63934,23687,54896,5135,9038,1388218.96
2018-03-02,CHI,DAL,6309,12479,5343,10864,1085,1615,234936.91
2018-03-02,LAC,NYK,6837,13342,6053,12014,902,1328,417864.09
2018-03-02,MEM,DEN,5175,10334,4612,9396,629,938,140593.3
2018-03-02,MIL,IND,8862,17165,7840,15458,1129,1707,298428.86
2018-03-02,ORL,DET,9458,20433,8545,19069,1001,1364,262161.61
2018-03-02,PHI,CHA,15692,34293,13980,31098,2018,3195,763939.57
2018-03-02,PHX,OKC,21414,49457,19358,45392,2474,4065,851083.8
2018-03-02,UTA,MIN,1893,3136,62,96,1831,3040,74307.78
2018-03-02,WAS,TOR,1166,1721,44,53,1122,1668,40993.13
2018-03-01,CLE,PHI,34894,107032,30864,99969,4317,7063,1508813.64
2018-03-01,MIA,LAL,32767,85575,28477,76643,5183,8932,1609889.87
2018-03-01,POR,MIN,9039,22185,7517,19611,1580,2574,302076.4
2018-03-01,SAC,BRK,7950,17126,6886,15316,1187,1810,300668.78
2018-02-28,ATL,IND,4893,9680,4457,9057,473,623,142077.23
2018-02-28,BOS,CHA,18319,37900,15807,33155,2920,4745,843295.21
2018-02-28,DAL,OKC,22851,51941,20748,47964,2444,3977,832557.61
2018-02-28,DET,MIL,12161,23932,10951,21926,1372,2006,412444.06
2018-02-28,LAC,HOU,2226,3609,102,169,2124,3440,73984.23
2018-02-28,MEM,PHX,4105,8224,3622,7432,528,792,117736.69
2018-02-28,ORL,TOR,7578,14912,6928,13855,727,1057,204873.18
2018-02-28,SAS,NOP,15336,31021,13759,28458,1786,2563,613154.92
2018-02-28,WAS,GSW,4040,7563,225,457,3815,7106,226995.6
2018-02-27,CHA,CHI,7155,14673,6300,13357,924,1316,345804.39
2018-02-27,CLE,BRK,39867,96830,36081,88621,4710,8209,1955781.91
2018-02-27,DEN,LAC,7610,18564,6639,17116,1027,1448,217066.56
2018-02-27,MIA,PHI,29120,62487,26055,56547,3598,5940,1306959.35
2018-02-27,MIL,WAS,13802,34983,12716,33365,1162,1618,445360.56
2018-02-27,POR,SAC,9056,17453,8391,16310,760,1143,412445.25
2018-02-26,ATL,LAL,21429,50949,18383,44818,3631,6131,943361.91
2018-02-26,BOS,MEM,17283,35593,15159,31703,2479,3890,829071.3
2018-02-26,BRK,CHI,5683,11591,5051,10560,709,1031,202006.58
2018-02-26,DAL,IND,8453,17697,7841,16652,703,1045,295393.69
2018-02-26,NOP,PHX,13167,26984,11876,24858,1421,2126,357289.04
2018-02-26,NYK,GSW,5055,9441,293,558,4765,8883,277209.17
2018-02-26,OKC,ORL,16764,35357,15320,32931,1663,2426,597067.81
2018-02-26,SAC,MIN,744,1123,38,64,706,1059,27574.65
2018-02-26,TOR,DET,7999,14502,7048,13105,1035,1397,270467.09
2018-02-26,UTA,HOU,29023,62290,26960,58135,2536,4155,1323450.44
2018-02-25,CHA,DET,17879,32180,15733,29129,2336,3051,543979.57
2018-02-25,CLE,SAS,6619,10537,310,482,6309,10055,245948.56
2018-02-25,DEN,HOU,41347,96244,38243,90434,3681,5810,1789737.86
2018-02-25,MIL,NOP,32552,68388,28645,62323,4328,6065,1145482.78
2018-02-25,WAS,PHI,1068,1569,61,107,1007,1462,34947.23
2018-02-24,GSW,OKC,10453,20187,487,822,9968,19365,514970.2
2018-02-24,MIA,MEM,14236,28347,12839,25949,1636,2398,425252.73
2018-02-24,MIN,CHI,14617,27817,13088,25382,1706,2435,404237.55
2018-02-24,NYK,BOS,39025,85632,35056,78161,4675,7471,1641845.18
2018-02-24,PHI,ORL,29233,54961,26601,50911,2930,4050,837318.2
2018-02-24,PHX,POR,16419,31853,14423,28390,2281,3463,405074.57
2018-02-24,SAC,LAL,34196,76869,30902,70360,3945,6509,1326119.41
2018-02-24,UTA,DAL,14398,28396,12959,25896,1645,2500,439739.79
2018-02-23,DEN,SAS,11591,23937,10269,21647,1522,2290,429733.7
2018-02-23,DET,BOS,25221,52666,21293,45725,4428,6941,1030259.19
2018-02-23,HOU,MIN,2826,4539,99,142,2729,4397,99437.19
2018-02-23,IND,ATL,3774,7344,3054,6218,792,1126,128518.14
2018-02-23,LAL,DAL,3229,5833,137,545,3092,5288,123583.77
2018-02-23,MEM,CLE,31660,87243,26559,75527,6262,11716,1516808.09
2018-02-23,NOP,MIA,16124,34906,14420,32222,1874,2684,584167.82
2018-02-23,PHX,LAC,3714,7467,3092,6481,660,986,115312.62
2018-02-23,TOR,MIL,19061,39537,16604,35437,2703,4100,646636.17
2018-02-23,UTA,POR,10622,23005,9323,20650,1461,2355,478288.77
2018-02-23,WAS,CHA,4561,8807,3913,7847,687,960,123410.62
2018-02-22,CHA,BRK,7277,14952,6483,13817,849,1135,214485.38
2018-02-22,CHI,PHI,20435,48438,17778,43102,3161,5336,881745.25
2018-02-22,CLE,WAS,36657,124109,33504,118438,3429,5671,1318044.74
2018-02-22,GSW,LAC,21722,60999,16789,50906,5246,10093,809676.07
2018-02-22,ORL,NYK,11505,24197,10049,21441,1714,2756,418691.52
2018-02-22,SAC,OKC,18000,40169,15789,36078,2636,4091,720877.39
2018-02-18,WST,EST,131672,672594,120702,644877,12906,27717,5895296.45
2018-02-17,WST,EST,82590,381798,75540,366602,8093,15196,2983059.69
2018-02-16,USA,WLD,33383,92057,27113,81548,6712,10509,852246.66
2018-02-15,MIL,DEN,17910,38860,15397,34665,2812,4195,1133813.64
2018-02-15,MIN,LAL,18716,56462,16183,51597,2687,4865,650406.28
2018-02-14,BOS,LAC,1967,3176,114,180,1853,2996,79051.58
2018-02-14,BRK,IND,6243,12748,5602,11690,715,1058,239968.76
2018-02-14,CHI,TOR,5412,10473,4604,9016,888,1457,234826.76
2018-02-14,DET,ATL,6830,12937,5711,11230,1220,1707,252287.41
2018-02-14,HOU,SAC,9786,20533,8235,17673,1747,2860,703168.49
2018-02-14,MEM,OKC,13147,27453,11441,24263,1946,3190,468156.37
2018-02-14,NOP,LAL,18511,41254,16379,37575,2395,3679,945344.51
2018-02-14,NYK,WAS,8807,18331,7747,16478,1204,1853,382929.0
2018-02-14,ORL,CHA,4206,7530,3555,6590,690,940,114383.93
2018-02-14,PHI,MIA,22682,49019,20200,44184,2966,4835,949871.3
2018-02-14,POR,GSW,5554,9830,295,689,5261,9141,270890.35
2018-02-14,UTA,PHX,11480,24229,10273,21815,1417,2414,537763.91
2018-02-13,DAL,SAC,5531,10802,4849,9676,753,1126,488674.86
2018-02-13,DEN,SAS,8490,20987,7579,19494,952,1493,378316.28
2018-02-13,MIL,ATL,6733,14264,5861,12965,938,1299,210867.22
2018-02-13,MIN,HOU,20571,47010,17571,41567,3421,5443,830945.03
2018-02-13,OKC,CLE,51387,208510,44118,191641,8139,16869,3037513.99
2018-02-13,TOR,MIA,20051,44320,18348,41652,1917,2668,882809.6
2018-02-12,BRK,LAC,6635,12421,5932,11444,768,977,212628.33
2018-02-12,CHI,ORL,12502,22797,11357,20936,1310,1861,452231.74
2018-02-12,DET,NOP,18986,36674,17324,34193,1838,2481,832638.24
2018-02-12,GSW,PHX,4481,8148,246,425,4237,7723,239435.81
2018-02-12,PHI,NYK,1868,3103,95,145,1773,2958,79835.12
2018-02-12,UTA,SAS,26850,55908,24471,51352,2941,4556,1409823.61
2018-02-11,ATL,DET,13506,28097,12342,26347,1286,1750,509842.44
2018-02-11,BOS,CLE,11418,24448,477,878,10950,23570,579128.02
2018-02-11,CHA,TOR,11413,21913,10162,20092,1382,1821,443950.3
2018-02-11,HOU,DAL,1630,2801,82,121,1551,2680,60056.38
2018-02-11,IND,NYK,13248,25608,12048,23530,1369,2078,659974.44
2018-02-11,MIN,SAC,13415,25256,12317,23498,1217,1758,539894.16
2018-02-11,OKC,MEM,16244,32448,14652,29687,1860,2761,795409.45
2018-02-11,POR,UTA,17512,37976,16106,35190,1717,2786,1124290.5
2018-02-10,BRK,NOP,14683,31291,13344,29201,1486,2090,564368.8
2018-02-10,CHI,WAS,8328,16514,7453,15052,994,1462,440599.68
2018-02-10,DAL,LAL,38672,104074,35003,97302,4313,6772,2015972.58
2018-02-10,GSW,SAS,4989,8700,260,437,4731,8263,243005.34
2018-02-10,ORL,MIL,9710,19708,8648,18051,1174,1657,342294.15
2018-02-10,PHI,LAC,15715,32498,14068,29707,1843,2791,692849.39
2018-02-10,PHX,DEN,9696,19085,8931,17708,880,1377,316735.21
2018-02-09,ATL,CLE,40039,102239,35186,91638,6099,10601,2064739.5
2018-02-09,BOS,IND,26627,57740,24281,53812,2654,3928,1206125.5
2018-02-09,CHI,MIN,2259,3596,88,149,2171,3447,87375.59
2018-02-09,DET,LAC,1771,2552,94,186,1677,2366,52462.89
2018-02-09,HOU,DEN,12099,24886,10141,21176,2238,3710,492753.86
2018-02-09,MIA,MIL,27316,63884,25094,59604,2720,4280,1280193.61
2018-02-09,PHI,NOP,13018,26139,11468,23522,1788,2617,505310.53
2018-02-09,SAC,POR,10671,19156,9550,17137,1260,2019,384880.1
2018-02-09,UTA,CHA,10679,21070,9599,18890,1308,2180,474350.3
2018-02-08,GSW,DAL,24921,57786,21829,50990,3838,6796,1543949.65
2018-02-08,LAL,OKC,15437,38228,12452,33264,3115,4964,431649.41
2018-02-08,ORL,ATL,8656,17019,7953,16012,781,1007,277233.64
2018-02-08,POR,CHA,9071,18867,8202,17440,974,1427,328158.26
2018-02-08,TOR,NYK,11844,24046,10830,22356,1178,1690,465342.78
2018-02-08,WAS,BOS,27139,82894,24611,78045,2725,4849,1105433.22
2018-02-07,CLE,MIN,4802,9143,273,436,4533,8707,226972.89
2018-02-07,DET,BRK,13979,28922,12306,26172,1947,2750,492767.5
2018-02-07,MEM,UTA,9070,18792,7954,16812,1334,1980,333204.79
2018-02-07,MIA,HOU,22751,50130,20282,45596,2935,4534,820478.98
2018-02-07,PHX,SAS,1129,1794,56,81,1073,1713,37629.69
2018-02-06,ATL,MEM,2253,4090,1957,3661,320,429,57647.13
2018-02-06,BRK,HOU,12367,27002,11034,24427,1574,2575,396197.37
2018-02-06,GSW,OKC,39547,147297,33099,133366,6884,13931,2856344.41
2018-02-06,LAL,PHX,14928,37578,12965,33513,2473,4065,719976.5
2018-02-06,NYK,MIL,14353,30750,13118,28499,1460,2251,729014.81
2018-02-06,ORL,CLE,36736,89371,33780,83831,3765,5540,1634007.75
2018-02-06,PHI,WAS,13132,33683,11994,31853,1223,1830,918951.46
2018-02-06,TOR,BOS,28573,60002,26004,55524,3168,4478,1300346.92
2018-02-05,DEN,CHA,1808,3202,1336,2472,496,730,82836.17
2018-02-05,DET,POR,1921,2918,89,195,1832,2723,67377.06
2018-02-05,IND,WAS,2335,4377,1741,3475,624,902,417721.03
2018-02-05,LAC,DAL,816,1208,40,90,776,1118,27286.03
2018-02-05,MIA,ORL,2357,4355,1873,3643,510,712,81740.3
2018-02-05,NOP,UTA,2782,5613,1902,4146,932,1467,123172.16
2018-02-05,SAC,CHI,2385,4478,1581,3107,834,1371,499339.84
2018-02-04,BOS,POR,26488,58399,22680,51470,4541,6929,1064910.79
2018-02-04,BRK,MIL,5729,16241,4988,14939,846,1302,170389.89
2018-02-04,NYK,ATL,8322,17970,7460,16642,950,1328,321910.4
2018-02-04,OKC,LAL,2996,4965,151,240,2846,4725,153222.17
2018-02-04,PHX,CHA,6719,13287,6271,12558,501,729,533010.61
2018-02-04,TOR,MEM,3490,6828,2951,5977,591,851,109521.02
2018-02-03,CLE,HOU,3725,6147,174,285,3552,5862,140458.76
2018-02-03,DEN,GSW,33536,76333,30424,70250,3730,6083,1712298.69
2018-02-03,DET,MIA,17028,37267,15070,34010,2329,3257,937366.76
2018-02-03,IND,PHI,13382,28126,12300,26336,1289,1790,542884.31
2018-02-03,LAC,CHI,10395,19663,8941,17418,1612,2245,398375.58
2018-02-03,MIN,NOP,8089,15540,6863,13602,1359,1938,366581.07
2018-02-03,ORL,WAS,4514,8777,4030,8046,546,731,160494.92
2018-02-03,SAC,DAL,6914,12234,6546,11557,438,677,230550.35
2018-02-03,SAS,UTA,11091,23884,9713,21232,1667,2652,679784.61
2018-02-02,BOS,ATL,18587,43030,15999,38055,3221,4975,850501.32
2018-02-02,BRK,LAL,16426,39882,14272,35540,2685,4342,599307.53
2018-02-02,CHA,IND,9653,20372,8744,18945,1040,1427,303156.87
2018-02-02,MIL,NYK,19803,42730,17851,39239,2318,3491,744819.7
2018-02-02,OKC,NOP,20969,48393,19086,44948,2268,3445,731924.63
2018-02-02,PHI,MIA,1324,2099,64,108,1260,1991,48560.3
2018-02-02,PHX,UTA,6454,13865,5299,11525,1406,2340,263232.72
2018-02-02,SAC,GSW,3126,5368,176,313,2951,5055,134658.75
2018-02-02,TOR,POR,6886,13239,5867,11627,1139,1612,236646.2
2018-02-01,DEN,OKC,15364,44067,12381,38145,3150,5922,475769.09
2018-02-01,DET,MEM,31680,68536,28791,63210,3518,5326,1127254.01
2018-02-01,MIN,MIL,15136,27174,13661,24593,1730,2581,1132500.85
2018-02-01,SAS,HOU,15857,45929,14469,43431,1481,2498,614740.93
2018-02-01,WAS,TOR,16238,33280,14881,30975,1570,2305,476971.88
2018-01-31,ATL,CHA,3074,6135,2736,5573,373,562,95654.71
2018-01-31,BOS,NYK,2125,3576,140,220,1986,3356,94734.63
2018-01-31,BRK,PHI,11419,24791,10467,22965,1125,1826,501143.51
2018-01-31,CLE,MIA,43972,112287,41091,105811,3715,6476,2092513.57
2018-01-31,IND,MEM,8215,16147,7573,14941,716,1206,250156.75
2018-01-31,ORL,LAL,14240,29041,13136,26886,1215,2155,514823.82
2018-01-31,PHX,DAL,510,845,37,51,473,794,14615.46
2018-01-31,POR,CHI,14887,26573,13605,24194,1513,2379,548875.36
2018-01-30,DET,CLE,25835,83931,23656,80062,2339,3869,1383016.78
2018-01-30,HOU,ORL,16917,34462,13053,27016,4263,7446,522454.79
2018-01-30,LAC,POR,783,1242,55,72,729,1170,25262.9
2018-01-30,NOP,SAC,4114,8471,3570,7444,628,1027,128878.15
2018-01-30,NYK,BRK,10438,23835,9199,21226,1591,2609,506623.33
2018-01-30,SAS,DEN,10676,21888,9412,19442,1527,2446,403867.78
2018-01-30,TOR,MIN,13163,25135,11812,22933,1540,2202,402868.45
2018-01-30,UTA,GSW,32707,73050,29111,65847,4370,7203,1477366.18
2018-01-30,WAS,OKC,29624,72956,27420,68905,2801,4051,1108730.99
2018-01-29,ATL,MIN,14372,26977,13325,25333,1207,1644,565948.77
2018-01-29,DAL,MIA,12212,24332,11401,22681,1002,1651,436735.3
2018-01-29,DEN,BOS,3469,6056,238,430,3234,5626,145298.76
2018-01-29,IND,CHA,11322,22162,10395,20648,1083,1514,393111.25
2018-01-29,MEM,PHX,4115,8058,3638,7328,529,730,391234.41
2018-01-29,MIL,PHI,24994,47569,22915,44142,2452,3427,1073155.87
2018-01-28,CHI,MIL,12534,23863,10795,21204,1954,2659,486698.71
2018-01-28,CLE,DET,33825,85992,29870,77058,5136,8934,1567084.37
2018-01-28,HOU,PHX,2035,3295,106,188,1929,3107,83663.03
2018-01-28,NOP,LAC,10607,20110,9509,18450,1212,1660,362324.29
2018-01-28,OKC,PHI,1710,3519,90,178,1620,3341,95167.51
2018-01-28,SAS,SAC,11548,21941,10346,19480,1441,2461,421762.54
2018-01-28,TOR,LAL,16192,36161,14194,32753,2332,3408,655536.38
2018-01-27,ATL,WAS,5025,9160,4393,8180,704,980,451000.5
2018-01-27,DEN,DAL,7771,14521,6983,13180,912,1341,216438.2
2018-01-27,DET,OKC,21124,47837,18322,42597,3153,5240,827374.2
2018-01-27,GSW,BOS,10793,22922,594,1210,10207,21712,683568.09
2018-01-27,IND,ORL,9561,18914,8552,17244,1183,1670,327834.0
2018-01-27,MIA,CHA,9544,19740,8423,17580,1401,2160,324562.31
2018-01-27,MIN,BRK,5943,10892,4857,9119,1210,1773,211225.35
2018-01-26,CHA,ATL,7362,13444,6688,12424,776,1020,256815.3
2018-01-26,CHI,LAL,21230,50070,18358,43993,3586,6077,1011493.06
2018-01-26,CLE,IND,35395,91008,30868,80818,5855,10190,1737633.37
2018-01-26,DAL,POR,5488,10908,4648,9339,960,1569,202730.62
2018-01-26,MEM,LAC,3094,5599,2515,4756,627,843,88980.5
2018-01-26,MIL,BRK,5126,9901,4104,8242,1139,1659,181933.98
2018-01-26,NOP,HOU,2359,3702,116,168,2244,3534,92544.56
2018-01-26,PHX,NYK,11482,22194,10060,19002,1786,3192,595279.41
2018-01-26,SAS,PHI,15374,30476,13274,26732,2473,3744,670268.23
2018-01-26,TOR,UTA,11104,22064,9456,18772,1960,3292,380608.11
2018-01-25,DEN,NYK,11804,24323,10616,22291,1420,2032,538658.02
2018-01-25,GSW,MIN,20129,55950,15615,47471,4774,8479,732627.23
2018-01-25,MIA,SAC,13780,29061,12152,26140,1928,2921,493973.55
2018-01-25,OKC,WAS,20485,61419,18128,56692,2547,4727,920733.12
2018-01-24,ATL,TOR,4986,8369,4466,7524,594,845,147598.75
2018-01-24,CHA,NOP,12620,24447,11514,22694,1240,1753,369050.68
2018-01-24,DAL,HOU,1423,2407,70,197,1353,2210,48502.71
2018-01-24,DET,UTA,12403,25144,11100,22699,1510,2445,429964.56
2018-01-24,IND,PHX,4805,9584,4174,8573,707,1011,166247.65
2018-01-24,LAC,BOS,2746,4544,157,224,2592,4320,113649.64
2018-01-24,MEM,SAS,9974,18032,8993,16143,1167,1889,393081.84
2018-01-24,PHI,CHI,15450,30565,13359,26901,2426,3664,727670.09
2018-01-24,POR,MIN,13845,26464,12225,23592,1895,2872,816018.62
2018-01-23,GSW,NYK,30901,76739,26622,66802,5639,9937,1857681.25
2018-01-23,LAL,BOS,23292,65922,18897,57424,4679,8498,748925.13
2018-01-23,OKC,BRK,20741,46425,18438,41918,2830,4507,841336.19
2018-01-23,ORL,SAC,10134,20062,9277,18598,998,1464,313584.41
2018-01-23,SAS,CLE,30880,101823,27572,95698,3537,6125,1264207.37
2018-01-22,ATL,UTA,8281,16235,7630,15122,773,1113,280094.36
2018-01-22,CHA,SAC,9649,17797,8909,16583,862,1214,329580.26
2018-01-22,DAL,WAS,6175,11454,5450,10213,837,1241,210694.45
2018-01-22,DEN,POR,12971,24644,12112,23074,994,1570,441582.47
2018-01-22,HOU,MIA,1997,3404,114,182,1884,3222,74706.25
2018-01-22,LAC,MIN,1434,2295,91,134,1346,2161,59095.25
2018-01-22,MEM,PHI,15538,30662,14607,29015,1146,1647,605841.67
2018-01-22,MIL,PHX,11872,22480,10828,20837,1199,1643,394848.35
2018-01-22,NOP,CHI,21214,46509,19143,42582,2424,3927,872071.57
2018-01-21,BOS,ORL,34886,74727,29832,66301,5682,8426,1242730.66
2018-01-21,DET,BRK,13447,24977,11619,22214,2040,2763,302182.39
2018-01-21,LAL,NYK,31835,77589,26236,66993,6572,10596,1206982.52
2018-01-21,SAS,IND,21300,42533,19339,39296,2294,3237,698121.95
2018-01-20,ATL,CHI,17608,32584,15599,29058,2348,3526,476129.72
2018-01-20,CHA,MIA,16378,34788,14396,30950,2459,3838,569205.39
2018-01-20,CLE,OKC,12166,22519,528,893,11639,21626,509597.92
2018-01-20,HOU,GSW,9793,19585,510,975,9293,18610,429465.17
2018-01-20,MIN,TOR,22596,43243,20496,39572,2443,3671,632193.02
2018-01-20,NOP,MEM,11308,21114,10353,19511,1092,1603,279510.45
2018-01-20,PHI,MIL,25019,49392,22313,44830,3253,4562,932974.83
2018-01-20,POR,DAL,12082,22904,11089,21069,1156,1835,373530.67
2018-01-20,UTA,LAC,10037,21591,8893,19462,1340,2129,355241.32
2018-01-19,BRK,MIA,21011,44725,19645,42208,1708,2517,581432.03
2018-01-19,DEN,PHX,15718,30796,14510,28374,1459,2422,444667.15
2018-01-19,DET,WAS,1154,1686,51,77,1103,1609,35882.15
2018-01-19,LAL,IND,28174,59976,24633,53272,4344,6704,1273761.72
2018-01-19,MEM,SAC,9160,15812,8492,14751,778,1061,203119.84
2018-01-19,TOR,SAS,35832,72556,32029,66241,4445,6315,1082757.21
2018-01-19,UTA,NYK,2735,4562,143,222,2592,4340,118435.49
2018-01-18,BOS,PHI,29309,83485,24795,76162,4789,7323,1905145.24
2018-01-18,CLE,ORL,68413,179111,61485,164512,8746,14599,2505210.6
2018-01-18,HOU,MIN,22117,59745,19080,54617,3266,5128,1134703.92
2018-01-18,POR,IND,17821,34871,15970,31725,2210,3146,530438.67
2018-01-17,ATL,NOP,17004,32271,15480,29875,1769,2396,334851.91
2018-01-17,BRK,SAS,12899,25254,11377,22501,1779,2753,505296.26
2018-01-17,CHA,WAS,17813,32724,16060,29989,2064,2735,579940.19
2018-01-17,CHI,GSW,62036,155943,54834,139200,9307,16743,2794162.19
2018-01-17,LAC,DEN,1022,1624,73,114,949,1510,34229.47
2018-01-17,MEM,NYK,13824,29277,12714,27421,1325,1856,535523.49
2018-01-17,MIL,MIA,23709,47781,21937,44296,2140,3485,799328.1
2018-01-17,OKC,LAL,3482,5829,147,214,3336,5615,113745.27
2018-01-17,SAC,UTA,16875,31983,15778,29748,1347,2235,643575.83
2018-01-17,TOR,DET,12955,24534,11733,22514,1427,2020,347527.31
2018-01-16,BOS,NOP,5952,10977,405,819,5550,10158,295500.8
2018-01-16,DEN,DAL,21374,40714,19957,38393,1702,2321,614720.83
2018-01-16,ORL,MIN,31911,66119,28847,60740,3643,5379,896458.12
2018-01-16,POR,PHX,1564,2391,93,136,1471,2255,49350.66
2018-01-15,ATL,SAS,1497,2296,94,148,1403,2148,43459.01
2018-01-15,BRK,NYK,18434,37853,16199,33265,2643,4588,689514.88
2018-01-15,CHI,MIA,22112,49780,19908,45596,2577,4184,738271.57
2018-01-15,CLE,GSW,69942,288854,59562,264425,11576,24429,3506698.08
2018-01-15,DET,CHA,1759,2554,127,398,1633,2156,29176.32
2018-01-15,LAC,HOU,16834,41514,11556,31763,5515,9751,520410.44
2018-01-15,MEM,LAL,22481,69635,21113,67467,1473,2168,791642.76
2018-01-15,OKC,SAC,24925,61286,22308,55912,3282,5374,882042.9
2018-01-15,PHI,TOR,34174,74836,30222,67885,4467,6951,1183451.45
2018-01-15,UTA,IND,11534,23919,10513,22018,1220,1901,394322.54
2018-01-15,WAS,MIL,30997,63822,28682,60129,2558,3693,979559.47
2018-01-14,MIA,MIL,13153,30971,10759,26801,2734,4170,531868.75
2018-01-14,MIN,POR,1551,2450,87,126,1464,2324,52309.99
2018-01-14,NYK,NOP,19110,42819,16111,37535,3366,5284,828450.46
2018-01-14,PHX,IND,9990,18512,9056,17000,1066,1512,338799.56
2018-01-13,CHA,OKC,14682,32159,12341,27697,2724,4462,554426.11
2018-01-13,CHI,DET,13665,28362,11800,24812,2279,3550,572603.41
2018-01-13,DAL,LAL,24334,65642,20187,57349,4894,8293,1085423.05
2018-01-13,LAC,SAC,5120,10233,4262,8855,953,1378,186490.02
2018-01-13,SAS,DEN,10830,20675,9369,17693,1742,2982,448130.79
2018-01-13,TOR,GSW,42703,103320,35547,87397,8851,15923,2112896.43
2018-01-13,WAS,BRK,7911,16119,7060,14778,954,1341,279366.17
2018-01-12,ATL,BRK,5133,9587,4604,8686,597,901,137559.64
2018-01-12,CHA,UTA,7475,16283,6456,14517,1170,1766,262414.96
2018-01-12,DEN,MEM,6422,12003,6039,11394,446,609,206000.17
2018-01-12,IND,CLE,42500,110955,37884,102125,5570,8830,1789579.33
2018-01-12,MIL,GSW,4316,7801,290,489,4027,7312,193083.26
2018-01-12,MIN,NYK,14118,30666,12398,27566,2040,3100,556440.92
2018-01-12,NOP,POR,8824,16834,7642,14959,1309,1875,296573.55
2018-01-12,PHX,HOU,1171,1897,56,96,1115,1801,38584.45
2018-01-12,WAS,ORL,6062,12352,5350,11254,795,1098,182217.08
2018-01-11,LAL,SAS,14486,42420,11350,36437,3338,5983,508475.47
2018-01-11,PHI,BOS,7979,13795,530,936,7455,12859,363750.05
2018-01-11,SAC,LAC,8428,17653,7614,16328,932,1325,346593.15
2018-01-11,TOR,CLE,24092,79973,21479,75315,2808,4658,999423.34
2018-01-10,BRK,DET,3951,7701,3380,6699,661,1002,198292.26
2018-01-10,CHA,DAL,8075,15879,7150,14340,1040,1539,228523.36
2018-01-10,DEN,ATL,6139,12275,5827,11754,371,521,247676.33
2018-01-10,GSW,LAC,3582,6725,231,427,3353,6298,138703.0
2018-01-10,HOU,POR,16507,34919,14481,31085,2354,3834,747658.79
2018-01-10,IND,MIA,12181,28862,11063,26669,1384,2193,551398.0
2018-01-10,MEM,NOP,6489,12160,5956,11401,588,759,164345.62
2018-01-10,MIL,ORL,4764,9098,4009,7929,831,1169,170845.19
2018-01-10,MIN,OKC,2050,3426,99,141,1952,3285,89143.67
2018-01-10,NYK,CHI,22474,69463,20575,65265,2347,4198,1006955.04
2018-01-10,WAS,UTA,11749,24229,10387,21609,1638,2620,412980.84
2018-01-09,DAL,ORL,11286,20646,10498,19339,929,1307,340136.88
2018-01-09,LAL,SAC,2699,4995,167,292,2532,4703,130402.2
2018-01-09,OKC,POR,2579,4030,158,235,2423,3795,99701.12
2018-01-09,TOR,MIA,22484,47698,19916,42903,3163,4795,843582.45
2018-01-08,BRK,TOR,14196,34014,13076,31938,1443,2076,441996.41
2018-01-08,CHI,HOU,12207,26972,10573,24102,1904,2870,393389.21
2018-01-08,GSW,DEN,28795,69068,24319,58817,5636,10251,1510438.31
2018-01-08,IND,MIL,1271,1837,74,144,1198,1693,38005.97
2018-01-08,LAC,ATL,6505,13324,5852,12333,726,991,168454.14
2018-01-08,MIN,CLE,36652,91430,32294,83110,5346,8320,1399871.23
2018-01-08,NOP,DET,11443,21007,10513,19539,1042,1468,284197.34
2018-01-08,SAC,SAS,11382,23322,10109,20645,1588,2677,444899.35
2018-01-07,DAL,NYK,19961,46467,18206,42851,2264,3616,947592.11
2018-01-07,LAL,ATL,23588,56293,21274,51233,3028,5060,986257.1
2018-01-07,MIA,UTA,14735,30319,12189,25833,2955,4486,518768.53
2018-01-07,PHX,OKC,25785,59990,23661,55978,2625,4012,960237.81
2018-01-07,POR,SAS,2063,3239,145,200,1922,3039,81588.45
2018-01-06,BRK,BOS,22942,49371,19476,42741,4114,6630,970498.43
2018-01-06,DET,HOU,11564,22974,9783,20120,1994,2854,350676.44
2018-01-06,IND,CHI,4666,9236,3851,7898,896,1338,156644.92
2018-01-06,LAC,GSW,29143,67002,21760,50827,8560,16175,1462816.98
2018-01-06,MIN,NOP,9467,17524,8145,15423,1451,2101,355061.44
2018-01-06,ORL,CLE,30768,82132,25894,70395,6213,11737,1444445.76
2018-01-06,SAC,DEN,8310,16591,7678,15342,755,1249,310189.34
2018-01-06,WAS,MIL,14658,28337,12977,25450,1911,2887,477586.58
2018-01-05,BOS,MIN,3686,6135,230,377,3459,5758,161622.24
2018-01-05,DAL,CHI,9242,18906,7970,16549,1485,2357,383375.83
2018-01-05,DEN,UTA,7444,14609,6612,13160,965,1449,275073.13
2018-01-05,LAL,CHA,20538,45723,18930,42747,2029,2976,814828.99
2018-01-05,MEM,WAS,714,1002,31,41,683,961,19586.44
2018-01-05,MIA,NYK,17743,43033,16238,40132,1884,2901,829506.44
2018-01-05,MIL,TOR,12455,23889,11106,21614,1555,2275,440704.89
2018-01-05,PHI,DET,14642,28968,12560,25276,2470,3692,622920.1
2018-01-05,POR,ATL,5900,11013,5354,10084,630,929,204436.93
2018-01-05,SAS,PHX,9546,19854,8167,17133,1637,2721,412229.74
2018-01-04,HOU,GSW,39265,141882,33329,129265,6469,12617,1761012.35
2018-01-04,LAC,OKC,17033,51935,14208,46730,3014,5205,640807.78
2018-01-03,BOS,CLE,6619,12216,428,656,6196,11560,292759.04
2018-01-03,BRK,MIN,9267,18302,8115,16378,1317,1924,277888.92
2018-01-03,CHI,TOR,6460,13496,5678,12158,904,1338,224903.8
2018-01-03,DAL,GSW,33076,81589,28166,70116,6305,11473,1603706.54
2018-01-03,DEN,PHX,5453,12315,4898,11238,668,1077,171738.15
2018-01-03,LAL,OKC,2788,5034,127,170,2664,4864,105554.77
2018-01-03,MIA,DET,7708,16966,6906,15218,1000,1748,275734.65
2018-01-03,MIL,IND,5479,11119,4618,9710,965,1409,204508.5
2018-01-03,ORL,HOU,10904,22877,9220,19955,1953,2922,299952.43
2018-01-03,PHI,SAS,24246,51681,21676,47041,3012,4640,915352.5
2018-01-03,UTA,NOP,8746,17707,7849,16147,1037,1560,291348.01
2018-01-03,WAS,NYK,10160,20976,9022,19138,1306,1838,391925.66
2018-01-02,CLE,POR,8511,16764,514,902,8016,15862,430897.07
2018-01-02,LAC,MEM,689,1023,50,70,639,953,22806.73
2018-01-02,NYK,SAS,27626,59755,24981,54612,3341,5143,1314724.98
2018-01-02,PHX,ATL,11934,24529,10846,22573,1327,1956,403050.25
2018-01-02,SAC,CHA,8554,15891,7855,14788,812,1103,322172.0
2018-01-01,BRK,ORL,6629,14983,5648,13450,1120,1533,196586.04
2018-01-01,CHI,POR,14370,29113,12791,26495,1817,2618,426961.51
2018-01-01,MIN,LAL,18785,39886,16476,36028,2668,3858,625844.51
2018-01-01,TOR,MIL,22631,53585,19685,48237,3465,5348,849362.67
2017-12-31,BOS,BRK,18045,38472,15242,33072,3323,5400,928648.77
2017-12-31,HOU,LAL,40227,121356,36034,112557,5105,8799,1625719.58
2017-12-31,IND,MIN,8027,15195,6901,13352,1276,1843,265572.62
2017-12-31,LAC,CHA,3115,6711,2541,5737,635,974,105895.59
2017-12-31,OKC,DAL,18176,44292,15771,39825,2831,4467,681398.57
2017-12-31,PHX,PHI,15619,34152,14197,31167,1765,2985,551915.07
2017-12-31,SAC,MEM,2334,4195,1969,3621,399,574,73221.19
2017-12-31,WAS,CHI,12687,27092,11257,24625,1664,2467,475552.31
2017-12-30,ATL,POR,5702,11078,5094,10072,691,1006,180404.72
2017-12-30,DEN,PHI,1701,2649,122,182,1580,2467,60817.25
2017-12-30,DET,SAS,13173,26878,11409,23825,2050,3053,480287.23
2017-12-30,GSW,MEM,32825,82128,25823,63308,8874,18820,1737564.23
2017-12-30,NOP,NYK,18555,41673,15791,35849,3380,5824,746044.77
2017-12-30,ORL,MIA,7188,16020,6206,14239,1142,1781,213381.33
2017-12-30,UTA,CLE,42073,110385,37753,101232,5460,9153,1885383.2
2017-12-29,CHI,IND,7019,14658,5928,12633,1283,2025,270225.48
2017-12-29,GSW,CHA,26681,60490,23692,54775,3680,5715,1272048.51
2017-12-29,LAL,LAC,17771,40744,16084,37602,2088,3142,759428.33
2017-12-29,MIA,BRK,4332,8787,3813,7879,622,908,161300.25
2017-12-29,NOP,DAL,7566,16093,6616,14393,1090,1700,247091.07
2017-12-29,OKC,MIL,30726,72183,27247,65681,4199,6502,1181293.62
2017-12-29,SAC,PHX,8325,16114,7768,15069,668,1045,283475.89
2017-12-29,TOR,ATL,7607,13808,6899,12662,845,1146,241181.04
2017-12-29,WAS,HOU,2369,3686,113,188,2257,3498,78691.92
2017-12-28,BOS,HOU,10764,23976,3100,9539,7737,14437,507943.81
2017-12-28,MIL,MIN,2681,4981,1291,2780,1416,2201,110156.14
2017-12-28,ORL,DET,1365,2359,861,1672,518,687,43754.8
2017-12-28,POR,PHI,2672,5217,1061,2541,1624,2676,118239.7
2017-12-28,SAS,NYK,3035,5619,1502,3122,1564,2496,148392.35
2017-12-27,ATL,WAS,9271,17633,9014,17180,329,453,276047.77
2017-12-27,CHA,BOS,25475,56556,23721,53197,2219,3359,922232.3
2017-12-27,CHI,NYK,17123,38408,16284,36821,1083,1587,709713.49
2017-12-27,GSW,UTA,1528,3008,140,237,1391,2771,78818.22
2017-12-27,IND,DAL,9112,18677,8595,17818,603,859,266634.21
2017-12-27,LAL,MEM,18744,42827,18181,41672,812,1155,806016.97
2017-12-27,MIN,DEN,16293,38393,15386,36739,1124,1654,561363.93
2017-12-27,NOP,BRK,4360,8168,3792,7298,621,870,128878.92
2017-12-27,OKC,TOR,1270,2329,86,159,1188,2170,51817.64
2017-12-27,SAC,CLE,30600,74753,29112,71768,2025,2985,1250302.85
2017-12-26,DAL,TOR,13252,28265,12144,26341,1293,1924,418252.85
2017-12-26,DEN,UTA,9318,22797,8593,21073,908,1724,335851.87
2017-12-26,DET,IND,11282,23429,10168,21551,1297,1878,371315.88
2017-12-26,LAC,SAC,557,861,40,65,517,796,19991.42
2017-12-26,MIA,ORL,9176,19464,8455,18052,903,1412,297798.91
2017-12-26,MIL,CHI,1460,2366,86,123,1374,2243,63258.68
2017-12-26,PHX,MEM,9973,22411,9002,20706,1139,1705,319600.7
2017-12-26,SAS,BRK,11854,24309,10437,21502,1730,2807,463633.54
2017-12-25,BOS,WAS,2620,4311,140,224,2481,4087,100221.71
2017-12-25,GSW,CLE,9639,19693,514,896,9137,18797,495539.36
2017-12-25,LAL,MIN,14282,42838,12132,39247,2258,3591,435191.62
2017-12-25,NYK,PHI,2774,4429,164,269,2612,4160,94327.16
2017-12-25,OKC,HOU,4516,8265,218,325,4301,7940,187716.15
2017-12-23,ATL,DAL,4144,7653,3699,6904,485,749,110089.62
2017-12-23,BOS,CHI,20232,43967,17379,38161,3503,5806,850046.81
2017-12-23,CHA,MIL,10983,21133,9971,19509,1139,1624,333294.16
2017-12-23,GSW,DEN,25363,56708,22276,50975,3599,5733,1070956.57
2017-12-23,IND,BRK,7951,17307,7010,15593,1067,1714,257085.11
2017-12-23,LAL,POR,24946,61557,22567,56854,2929,4703,1008519.11
2017-12-23,MEM,LAC,3193,6430,2660,5597,573,833,95710.82
2017-12-23,MIA,NOP,5263,10977,4587,9875,769,1102,253144.61
2017-12-23,PHX,MIN,6280,12095,5400,10635,976,1460,205274.98
2017-12-23,SAC,SAS,9723,18328,8439,15811,1501,2517,407775.37
2017-12-23,TOR,PHI,15964,32085,14182,29187,2003,2898,606897.07
2017-12-23,UTA,OKC,17152,41079,14745,36058,2989,5021,651631.91
2017-12-23,WAS,ORL,3912,7286,3346,6447,608,839,115824.23
2017-12-22,BRK,WAS,5564,10485,4993,9497,662,988,163828.5
2017-12-22,DET,NYK,17729,37844,15889,34570,2198,3274,689915.75
2017-12-22,GSW,LAL,5150,9257,324,526,4832,8731,233995.35
2017-12-22,HOU,LAC,2058,3469,134,200,1925,3269,78713.96
2017-12-22,MIA,DAL,5813,12788,5102,11364,875,1424,285501.14
2017-12-22,MIL,CHA,9012,17773,7956,15932,1198,1841,338801.27
2017-12-22,OKC,ATL,17235,40137,15007,35589,2703,4548,625425.38
2017-12-22,ORL,NOP,7343,14471,6556,13204,908,1267,222689.41
2017-12-22,POR,DEN,7757,14952,7178,13865,698,1087,284204.23
2017-12-21,CLE,CHI,40555,101251,35213,89183,6729,12068,1713655.14
2017-12-21,NYK,BOS,23577,72435,20312,66245,3515,6190,739677.79
2017-12-21,PHI,TOR,21533,45010,19671,41800,2117,3210,736742.4
2017-12-21,PHX,MEM,8647,15535,7953,14403,787,1132,264314.03
2017-12-21,UTA,SAS,1428,2432,95,181,1334,2251,54549.09
2017-12-20,ATL,IND,5660,11530,5133,10597,632,933,185780.87
2017-12-20,BOS,MIA,32235,71259,29387,65683,3559,5576,1385123.21
2017-12-20,BRK,SAC,5275,10391,4756,9412,604,979,177903.01
2017-12-20,CHA,TOR,9033,16313,8137,14918,1020,1395,279033.63
2017-12-20,CHI,ORL,6224,12811,5462,11440,904,1371,231468.76
2017-12-20,DAL,DET,6153,11362,5582,10338,674,1024,219681.56
2017-12-20,DEN,MIN,12004,22939,11027,21066,1183,1873,388462.02
2017-12-20,GSW,MEM,3460,6652,276,529,3188,6123,186479.45
2017-12-20,HOU,LAL,6255,14427,398,840,5866,13587,340686.6
2017-12-20,LAC,PHX,5324,10045,4935,9412,453,633,160551.79
2017-12-20,OKC,UTA,17284,37226,15353,33309,2419,3917,633875.1
2017-12-20,POR,SAS,17435,34349,15783,30954,2037,3395,699864.16
2017-12-19,MIL,CLE,5277,9799,456,777,4838,9022,236078.27
2017-12-19,PHI,SAC,19214,40344,17737,37666,1769,2678,611964.79
2017-12-19,WAS,NOP,12102,24894,10722,22646,1574,2248,335056.81
2017-12-18,ATL,MIA,7596,17118,7219,16316,501,802,189248.28
2017-12-18,CHA,NYK,11581,22609,10666,20954,1136,1655,337705.24
2017-12-18,CHI,PHI,16085,35499,14694,32838,1754,2661,779141.67
2017-12-18,DAL,PHX,6116,11772,5755,11016,449,756,142377.59
2017-12-18,HOU,UTA,16463,38824,14672,34699,2323,4125,510043.98
2017-12-18,IND,BOS,4430,8373,411,780,4040,7593,187505.34
2017-12-18,LAL,GSW,7187,16056,709,1288,6505,14768,430616.31
2017-12-18,MIN,POR,11705,22284,10266,19627,1674,2657,299832.61
2017-12-18,OKC,DEN,16820,39115,14855,35141,2425,3974,420093.14
2017-12-18,SAS,LAC,9665,18848,8748,16893,1179,1955,316966.19
2017-12-17,BRK,IND,8156,16596,7124,14947,1159,1649,183844.94
2017-12-17,DET,ORL,9640,18100,8301,15986,1503,2114,195317.61
2017-12-17,TOR,SAC,12390,24580,10744,22032,1882,2548,264990.88
2017-12-17,WAS,CLE,55476,145219,48821,130146,8432,15073,1857636.71
2017-12-16,CHA,POR,16873,31928,15230,29159,1994,2769,508582.23
2017-12-16,CLE,UTA,47725,125102,41963,111522,7722,13580,1533694.86
2017-12-16,HOU,MIL,34680,78320,30623,69944,4882,8376,982267.71
2017-12-16,MEM,BOS,27062,56306,24437,50932,3288,5374,1108477.13
2017-12-16,MIA,LAC,8416,17458,7684,16016,883,1442,179890.77
2017-12-16,MIN,PHX,11125,21365,9760,19041,1562,2324,235102.84
2017-12-16,NYK,OKC,4530,8530,410,716,4131,7814,225664.11
2017-12-16,SAS,DAL,14292,27235,12169,23016,2612,4219,310825.87
2017-12-15,BOS,UTA,28775,66285,25355,59312,4186,6973,937947.72
2017-12-15,CHA,MIA,7819,15576,6480,13374,1510,2202,192560.37
2017-12-15,DEN,NOP,13382,27293,12384,25410,1191,1883,353050.79
2017-12-15,HOU,SAS,3408,5788,214,318,3196,5470,118492.18
2017-12-15,IND,DET,9431,19964,8434,18154,1180,1810,288288.41
2017-12-15,MEM,ATL,3626,6147,3216,5503,455,644,56054.55
2017-12-15,MIL,CHI,11230,23030,9985,20461,1478,2569,302868.82
2017-12-15,ORL,POR,5694,11705,4816,10218,988,1487,159896.12
2017-12-15,PHI,OKC,7620,15141,553,944,7079,14197,381233.81
2017-12-15,TOR,BRK,3912,7758,3358,6780,632,978,80110.26
2017-12-15,WAS,LAC,6466,12285,5693,10987,881,1298,139523.25
2017-12-14,ATL,DET,6252,13117,5349,11620,1029,1497,152770.23
2017-12-14,BRK,NYK,15504,38280,13776,34515,2250,3765,621945.15
2017-12-14,CLE,LAL,38037,142776,32490,130553,6173,12223,1265053.94
2017-12-14,GSW,DAL,13712,35534,10140,28393,3793,7141,478074.9
2017-12-14,MIN,SAC,7403,14871,6338,13007,1197,1864,210977.82
2017-12-13,BOS,DEN,23717,53965,20851,48231,3493,5734,969715.18
2017-12-13,CHI,UTA,9915,21165,8935,19253,1193,1912,286233.5
2017-12-13,HOU,CHA,1566,2617,80,102,1486,2515,54966.81
2017-12-13,IND,OKC,2298,3916,175,257,2126,3659,85269.7
2017-12-13,MIA,POR,8918,19275,8160,17750,902,1525,250308.3
2017-12-13,NOP,MIL,13790,26516,12393,24064,1598,2452,359871.32
2017-12-13,ORL,LAC,4951,10619,4466,9796,573,823,111837.64
2017-12-13,PHX,TOR,7799,14766,7406,14058,485,708,211101.78
2017-12-13,WAS,MEM,4908,9621,4438,8869,536,752,115022.03
2017-12-12,BRK,WAS,9818,20350,9294,19365,656,985,307341.37
2017-12-12,CLE,ATL,27305,74644,24104,66480,4370,8164,1165604.23
2017-12-12,DAL,SAS,21346,49324,19789,46057,2144,3267,669970.52
2017-12-12,DET,DEN,6304,13287,5637,12163,767,1124,152521.77
2017-12-12,MIN,PHI,2412,4324,133,193,2283,4131,106615.22
2017-12-12,NYK,LAL,4015,8282,297,452,3723,7830,208755.02
2017-12-12,SAC,PHX,6400,14123,5932,13061,607,1062,222255.26
2017-12-11,CHI,BOS,25558,56449,23449,52602,2641,3847,742813.45
2017-12-11,GSW,POR,30137,69434,25973,59821,5437,9613,1627020.98
2017-12-11,HOU,NOP,2948,5396,219,365,2737,5031,143001.58
2017-12-11,LAC,TOR,560,908,56,89,504,819,19973.26
2017-12-11,MEM,MIA,6612,13418,6101,12334,635,1084,188550.38
2017-12-11,OKC,CHA,19460,44445,17965,41676,1895,2769,584692.72
2017-12-10,DET,BOS,23952,55363,20809,48904,3818,6459,939955.0
2017-12-10,IND,DEN,10594,22628,9371,20194,1432,2434,387572.38
2017-12-10,MIN,DAL,9526,19662,8578,18025,1086,1637,259065.81
2017-12-10,NOP,PHI,20328,43434,18342,39785,2353,3649,661993.69
2017-12-10,NYK,ATL,12932,31290,11852,28660,1414,2630,559478.51
2017-12-10,SAC,TOR,6556,13814,5811,12510,873,1304,162731.89
2017-12-09,ATL,ORL,5309,10576,5054,10143,315,433,105303.05
2017-12-09,BRK,MIA,659,1032,65,122,594,910,25083.13
2017-12-09,CHA,LAL,24145,61900,21617,55776,3387,6124,949478.19
2017-12-09,CHI,NYK,11137,27243,10079,24879,1364,2364,415610.02
2017-12-09,CLE,PHI,44133,116871,39882,104855,5861,12016,1848201.34
2017-12-09,LAC,WAS,10993,21925,9740,19820,1443,2105,315901.9
2017-12-09,MEM,OKC,21230,52851,19354,48257,2618,4594,698388.22
2017-12-09,MIL,UTA,1148,2040,46,73,1106,1967,50464.94
2017-12-09,PHX,SAS,9517,20835,8490,18749,1243,2086,326264.65
2017-12-09,POR,HOU,22047,50523,19818,45094,2877,5429,895378.48
2017-12-08,CHA,CHI,8583,18192,7756,16571,972,1621,216468.1
2017-12-08,DET,GSW,4055,8399,357,680,3709,7719,203598.99
2017-12-08,IND,CLE,36116,102987,33129,96714,3810,6273,1434190.08
2017-12-08,MEM,TOR,4470,9380,4123,8636,424,744,120862.73
2017-12-08,MIL,DAL,9002,18568,8194,16999,971,1569,265871.9
2017-12-08,NOP,SAC,8453,17288,7563,15434,1076,1854,214163.51
2017-12-08,ORL,DEN,3962,9005,3564,8292,479,713,99485.71
2017-12-08,SAS,BOS,3828,7130,155,318,3679,6812,157135.98
2017-12-07,BRK,OKC,16600,38766,15080,35870,1907,2896,544341.42
2017-12-07,PHI,LAL,26187,87723,22515,79689,4006,8034,836574.81
2017-12-07,PHX,WAS,9213,19388,8489,18087,886,1301,211108.73
2017-12-07,UTA,HOU,9044,23971,7453,20918,1674,3053,222576.22
2017-12-06,BOS,DAL,30092,75947,27220,68998,3865,6949,915317.19
2017-12-06,CHA,GSW,3259,6745,284,514,2981,6231,149448.94
2017-12-06,CLE,SAC,38666,105623,34618,95115,5758,10508,1317854.78
2017-12-06,IND,CHI,7491,16263,6401,14347,1279,1916,164905.4
2017-12-06,LAC,MIN,765,1233,83,123,684,1110,28740.51
2017-12-06,MIL,DET,14462,27982,13161,25699,1515,2283,378345.92
2017-12-06,NOP,DEN,6897,14380,6048,13002,937,1378,163383.44
2017-12-06,NYK,MEM,10797,24309,9539,21336,1613,2973,409820.54
2017-12-06,ORL,ATL,8078,17320,7681,16632,481,688,132774.11
2017-12-06,SAS,MIA,12580,25697,11401,23108,1512,2589,390794.67
2017-12-05,OKC,UTA,36596,90360,32877,81726,5058,8634,1308496.9
2017-12-05,POR,WAS,1409,2280,106,172,1307,2108,50100.33
2017-12-05,TOR,PHX,1033,1764,101,215,935,1549,28144.85
2017-12-04,ATL,BRK,3030,6059,2698,5379,397,680,74482.19
2017-12-04,BOS,MIL,4719,9114,386,657,4345,8457,213981.09
2017-12-04,CHA,ORL,7250,15327,6539,14166,815,1161,161882.84
2017-12-04,CHI,CLE,26376,73345,22972,63495,4688,9850,1033214.2
2017-12-04,DAL,DEN,4887,10046,4381,9131,594,915,124362.53
2017-12-04,IND,NYK,9198,18638,8273,16865,1118,1773,252634.32
2017-12-04,MEM,MIN,8681,17474,7919,16087,881,1387,179786.37
2017-12-04,NOP,GSW,38676,98117,34310,86521,5738,11596,1635614.52
2017-12-04,PHI,PHX,19756,44155,17704,40079,2492,4076,593600.84
2017-12-04,SAS,DET,15688,31402,14281,28304,1779,3098,495070.84
2017-12-04,UTA,WAS,9754,18973,8711,16877,1292,2096,269499.95
2017-12-03,LAL,HOU,3093,5844,241,426,2861,5418,120042.1
2017-12-03,MIA,GSW,32339,79809,28447,70269,5109,9540,1422809.85
2017-12-03,MIN,LAC,12252,24318,11020,22108,1430,2210,347367.72
2017-12-03,NYK,ORL,13317,28360,11581,25520,2006,2840,469317.13
2017-12-03,OKC,SAS,3277,6162,296,430,2992,5732,130545.75
2017-12-02,BOS,PHX,23324,55444,18582,46237,5501,9207,1118973.77
2017-12-02,BRK,ATL,4932,9408,4477,8623,513,785,200340.05
2017-12-02,CLE,MEM,29927,83198,26051,73157,5270,10041,1455229.78
2017-12-02,DAL,LAC,5506,10700,4637,9239,966,1461,180877.27
2017-12-02,DEN,LAL,23410,62771,21564,58675,2447,4096,1159983.53
2017-12-02,MIL,SAC,10709,21259,9635,19275,1288,1984,305675.64
2017-12-02,PHI,DET,27179,65413,24363,59693,3550,5720,1212112.17
2017-12-02,POR,NOP,10690,21735,9685,19863,1189,1872,432680.76
2017-12-01,CHI,SAC,6786,13778,5937,12050,1011,1728,231091.51
2017-12-01,MEM,SAS,8713,17996,7660,15655,1317,2341,420106.39
2017-12-01,MIA,CHA,8912,18652,8229,17235,849,1417,272117.63
2017-12-01,OKC,MIN,3407,6314,213,316,3204,5998,163573.45
2017-12-01,ORL,GSW,29563,72047,24837,60215,5985,11832,1636822.96
2017-12-01,TOR,IND,9247,19365,8510,17995,900,1370,267992.39
2017-12-01,UTA,NOP,14806,29564,12939,25545,2252,4019,582796.07
2017-12-01,WAS,DET,10537,23105,9591,21400,1130,1705,343939.53
2017-11-30,ATL,CLE,37801,112019,33913,101484,5548,10535,2371341.74
2017-11-30,BOS,PHI,5258,9764,549,960,4732,8804,275921.09
2017-11-30,DEN,CHI,13268,27570,12126,25479,1430,2091,504557.73
2017-11-30,LAC,UTA,10952,24338,10021,22357,1223,1981,515921.56
2017-11-30,POR,MIL,1358,2240,104,160,1257,2080,72202.0
2017-11-29,DAL,BRK,7984,15974,7528,15092,559,882,329004.04
2017-11-29,DET,PHX,7489,15429,6422,13565,1281,1864,219045.24
2017-11-29,HOU,IND,15711,34398,14023,31022,2065,3376,579479.0
2017-11-29,LAL,GSW,8164,17482,948,1896,7243,15586,538568.74
2017-11-29,NOP,MIN,11878,22483,10603,20199,1458,2284,377748.98
2017-11-29,NYK,MIA,12659,28808,11059,25306,2083,3502,519465.06
2017-11-29,ORL,OKC,25688,61627,23375,57131,2836,4496,784948.41
2017-11-29,PHI,WAS,2408,4217,243,399,2167,3818,114851.05
2017-11-29,SAS,MEM,12219,24038,11036,21573,1460,2465,780362.62
2017-11-29,TOR,CHA,7234,14390,6645,13257,719,1133,184582.75
2017-11-28,CHI,PHX,10657,22689,9575,20783,1337,1906,364906.85
2017-11-28,CLE,MIA,4930,9966,483,880,4470,9086,279923.03
2017-11-28,MIN,WAS,22543,44238,20646,40801,2364,3437,1053334.12
2017-11-28,SAC,MIL,14093,26543,13063,24554,1269,1989,724970.58
2017-11-28,UTA,DEN,815,1361,72,101,744,1260,29643.09
2017-11-27,BOS,DET,42354,100563,39413,94022,3919,6541,2811015.74
2017-11-27,GSW,SAC,28315,67355,25347,61400,3791,5955,2060471.65
2017-11-27,HOU,BRK,14159,28671,12779,25952,1721,2719,532612.23
2017-11-27,IND,ORL,7341,16179,6501,14740,977,1439,308089.51
2017-11-27,LAC,LAL,29304,92640,27181,87546,3136,5094,2090063.97
2017-11-27,NYK,POR,14614,33383,13380,30943,1555,2440,717861.72
2017-11-27,PHI,CLE,54084,146215,49081,133597,7061,12618,3325717.37
2017-11-27,SAS,DAL,1561,2866,159,258,1405,2608,70507.09
2017-11-26,CHI,MIA,9665,21615,7892,18656,2026,2959,435290.21
2017-11-26,MEM,BRK,8616,16966,7712,15312,1117,1654,344881.59
2017-11-26,MIN,PHX,9515,19241,7234,15539,2474,3702,414687.09
2017-11-25,ATL,TOR,4185,7769,3804,7083,442,686,93958.28
2017-11-25,CHA,SAS,9234,19467,7907,16812,1579,2655,382043.62
2017-11-25,DAL,OKC,15827,36742,13734,33031,2481,3711,563565.45
2017-11-25,GSW,NOP,34571,90245,30477,80077,5341,10168,2342384.36
2017-11-25,HOU,NYK,2416,4407,138,242,2287,4165,107524.05
2017-11-25,IND,BOS,25707,65765,22557,58407,4129,7358,1302425.87
2017-11-25,PHI,ORL,16296,37259,14250,33493,2470,3766,648835.37
2017-11-25,SAC,LAC,8975,17643,8241,16276,877,1367,592602.06
2017-11-25,UTA,MIL,11860,24782,10724,22179,1395,2603,370114.56
2017-11-25,WAS,POR,11528,24715,9891,21494,1936,3221,411412.94
2017-11-24,ATL,NYK,14083,35105,13055,33064,1351,2041,614246.42
2017-11-24,BOS,ORL,23345,55352,20188,48335,4093,7017,1091447.16
2017-11-24,BRK,POR,10858,22676,8285,18216,2843,4460,408363.76
2017-11-24,CLE,CHA,4963,10273,572,1013,4422,9260,244216.56
2017-11-24,DEN,MEM,6875,13802,6335,12783,649,1019,394220.41
2017-11-24,GSW,CHI,4694,9487,279,499,4434,8988,262985.19
2017-11-24,IND,TOR,9715,19754,8972,18321,913,1433,247555.38
2017-11-24,MIN,MIA,9833,22288,8726,20094,1356,2194,430186.23
2017-11-24,OKC,DET,23861,58066,20990,52231,3585,5835,744403.24
2017-11-24,PHX,NOP,7583,14900,6915,13724,796,1176,246586.49
2017-11-22,ATL,LAC,3154,6523,2755,5765,457,758,68805.09
2017-11-22,CHA,WAS,11137,24126,9793,21836,1532,2290,249811.48
2017-11-22,CLE,BRK,25529,70739,22082,61780,4668,8959,1330860.73
2017-11-22,HOU,DEN,8223,19323,6546,15841,1990,3482,275130.76
2017-11-22,MEM,DAL,5870,11406,4975,9711,1062,1695,126243.42
2017-11-22,MIA,BOS,37496,103812,34831,97925,3537,5887,2160055.48
2017-11-22,MIN,ORL,5901,12097,5010,10484,1000,1613,223908.15
2017-11-22,NOP,SAS,6977,14533,5880,12558,1224,1975,233610.8
2017-11-22,NYK,TOR,12151,32579,10068,26834,2830,5744,658532.14
2017-11-22,OKC,GSW,9028,20769,688,1265,8363,19504,751325.88
2017-11-22,PHI,POR,18442,44453,16166,39568,2894,4885,776814.54
2017-11-22,PHX,MIL,14258,31536,13296,29688,1158,1848,547644.27
2017-11-22,SAC,LAL,1826,3164,189,305,1639,2859,80094.84
2017-11-22,UTA,CHI,5559,11735,4918,10441,768,1294,269419.33
2017-11-21,LAL,CHI,4389,8658,652,1152,3767,7506,195942.86
2017-11-20,CHA,MIN,11418,23909,9901,21328,1720,2581,322715.43
2017-11-20,DAL,BOS,44679,127111,39944,113970,6600,13141,3190390.42
2017-11-20,DET,CLE,30324,77874,26070,67704,5647,10170,1162109.77
2017-11-20,MEM,POR,7042,15791,6152,13899,1035,1892,453655.65
2017-11-20,MIL,WAS,12559,25163,11238,22759,1533,2404,715418.97
2017-11-20,NOP,OKC,27558,70877,24745,64521,3497,6356,1343410.75
2017-11-20,NYK,LAC,14620,33212,13005,29313,2191,3899,826999.07
2017-11-20,ORL,IND,762,1347,98,171,669,1176,28219.18
2017-11-20,PHI,UTA,18787,42572,16121,37228,3214,5344,968551.11
2017-11-20,SAC,DEN,9478,19170,8930,18087,679,1083,505510.55
2017-11-20,SAS,ATL,6497,14217,5513,12181,1195,2036,372054.08
2017-11-19,BRK,GSW,27572,68637,23395,58779,5219,9858,2365687.02
2017-11-19,LAL,DEN,29180,85723,25964,77664,4464,8059,1571603.5
2017-11-19,MIA,IND,9519,19647,8608,18048,1086,1599,320643.79
2017-11-19,MIN,DET,20031,44469,18158,40651,2383,3818,798040.01
2017-11-19,PHX,CHI,11062,27123,10212,25452,1071,1671,572192.17
2017-11-19,TOR,WAS,12779,26145,11264,23554,1782,2591,406456.64
2017-11-18,ATL,BOS,28211,81387,24458,71973,4985,9414,1349660.69
2017-11-18,CHA,LAC,10227,20274,9329,18797,1070,1477,208830.7
2017-11-18,DAL,MIL,13944,26904,12931,25132,1234,1772,651748.7
2017-11-18,MEM,HOU,15876,33708,14552,30868,1673,2840,592130.31
2017-11-18,ORL,UTA,7886,16649,6846,14433,1238,2216,233982.45
2017-11-18,PHI,GSW,57983,170780,50330,149678,10489,21102,4270539.02
2017-11-18,POR,SAC,10333,20882,9600,19423,923,1459,708862.29
2017-11-17,BRK,UTA,5385,12784,4751,11555,753,1229,181029.46
2017-11-17,CHI,CHA,8453,17490,7487,15535,1187,1955,235449.84
2017-11-17,CLE,LAC,39495,121002,35252,108884,5939,12118,2247336.39
2017-11-17,DAL,MIN,10117,21455,9114,19289,1266,2166,618997.96
2017-11-17,DEN,NOP,1069,1640,143,220,928,1420,31027.27
2017-11-17,IND,DET,10942,25017,9769,22796,1429,2221,455191.06
2017-11-17,LAL,PHX,25143,70187,22951,65374,2851,4813,1367911.23
2017-11-17,SAC,POR,9399,20424,8643,18746,944,1678,322815.08
2017-11-17,SAS,OKC,4027,7603,783,1246,3271,6357,204687.97
2017-11-17,TOR,NYK,11076,27536,9969,25243,1368,2293,666232.95
2017-11-17,WAS,MIA,13002,31146,11932,28946,1361,2200,482695.47
2017-11-16,BOS,GSW,80689,345740,73369,327789,8298,17951,2848303.24
2017-11-16,PHX,HOU,17958,47995,15783,43820,2315,4175,521106.84
2017-11-15,ATL,SAC,6005,11792,5155,10418,983,1374,167580.09
2017-11-15,CHA,CLE,3671,7509,964,1702,2767,5807,153154.09
2017-11-15,LAL,PHI,7218,14692,1509,2502,5781,12190,315478.93
2017-11-15,MEM,IND,7327,15519,6670,14350,760,1169,499364.66
2017-11-15,MIA,WAS,13985,33050,12944,30963,1366,2087,601325.76
2017-11-15,MIL,DET,17911,40231,16171,36722,2106,3509,730827.46
2017-11-15,MIN,SAS,14188,30846,12454,27542,2024,3304,826722.53
2017-11-15,NOP,TOR,7136,15569,6336,14081,928,1488,275531.87
2017-11-15,NYK,UTA,22696,61393,20438,55661,3106,5732,1379812.63
2017-11-15,OKC,CHI,14159,36773,12380,32829,2247,3944,834480.39
2017-11-15,POR,ORL,12931,27684,12027,25768,1150,1916,782626.01
2017-11-14,BRK,BOS,39807,111445,35661,101688,5555,9757,2451539.08
2017-11-14,DAL,SAS,20311,45216,18653,41645,2086,3571,1065393.64
2017-11-14,HOU,TOR,3203,5537,1127,1933,2101,3604,108224.61
2017-11-13,GSW,ORL,30938,78373,27535,69933,4666,8440,3347743.21
2017-11-13,LAC,PHI,23329,60911,20634,54454,3437,6457,1973148.47
2017-11-13,MIL,MEM,21739,44318,20139,41197,1981,3121,668674.29
2017-11-13,NOP,ATL,13413,26189,12424,24530,1172,1659,336044.31
2017-11-13,NYK,CLE,64075,213082,57802,193494,9545,19588,4256874.09
2017-11-13,PHX,LAL,30648,91366,28275,84813,3458,6553,2121495.72
2017-11-13,POR,DEN,11493,24342,10663,22638,1021,1704,636941.94
2017-11-13,UTA,MIN,10889,23755,9629,21304,1507,2451,438218.75
2017-11-13,WAS,SAC,1400,2283,533,895,876,1388,30415.93
2017-11-12,BOS,TOR,38670,145922,33324,132385,7344,13537,1767292.65
2017-11-12,DET,MIA,14337,36863,12748,33523,1987,3340,589320.88
2017-11-12,IND,HOU,18023,40591,16187,36932,2295,3659,1000545.19
2017-11-12,OKC,DAL,25367,64514,22795,58908,3271,5606,1520098.0
2017-11-11,DAL,CLE,29755,88153,26762,79872,4043,8281,1357191.6
2017-11-11,DEN,ORL,5579,12097,4878,10721,818,1376,166716.14
2017-11-11,GSW,PHI,38402,111034,33198,96567,7019,14467,2967329.13
2017-11-11,HOU,MEM,11451,25471,10011,22591,1784,2880,369729.63
2017-11-11,MIL,LAL,30927,102848,27204,93037,4879,9811,1451965.76
2017-11-11,NOP,LAC,14150,30230,12794,27824,1650,2406,394525.5
2017-11-11,NYK,SAC,13080,34075,11037,28298,2731,5777,677310.93
2017-11-11,PHX,MIN,14667,30550,13530,28081,1392,2469,444125.08
2017-11-11,SAS,CHI,5939,13560,4647,10642,1551,2918,272546.6
2017-11-11,UTA,BRK,1233,2564,407,722,855,1842,59431.3
2017-11-11,WAS,ATL,8989,18949,8117,16983,1066,1966,221327.06
2017-11-10,BOS,CHA,34793,98577,31138,88882,5567,9695,1980134.85
2017-11-10,CHI,IND,7499,16653,6745,15303,932,1350,211839.84
2017-11-10,DET,ATL,14072,32072,12642,29300,1864,2772,586165.17
2017-11-10,OKC,LAC,26888,69512,23547,61269,4369,8243,1617335.86
2017-11-10,PHX,ORL,6268,15225,5409,13603,1014,1622,248347.68
2017-11-10,POR,BRK,11733,23964,10793,22082,1154,1882,595576.01
2017-11-10,SAS,MIL,3023,5063,456,740,2580,4323,184421.96
2017-11-10,UTA,MIA,8679,22968,7664,20663,1286,2305,449452.83
2017-11-09,DEN,OKC,18382,55456,16642,52324,1871,3132,503506.06
2017-11-09,HOU,CLE,45302,170858,41257,162280,4500,8578,1565580.02
2017-11-09,SAC,PHI,22108,57493,19691,51756,3301,5737,1387128.6
2017-11-09,TOR,NOP,16761,38226,15530,36020,1495,2206,721448.44
2017-11-09,WAS,LAL,31407,90677,28681,84775,3492,5902,1321646.99
2017-11-08,BOS,LAL,5812,11684,1879,3483,4003,8201,285831.08
2017-11-08,DET,IND,14107,32644,12696,29972,1739,2672,435961.07
2017-11-08,GSW,MIN,6016,11904,962,1650,5110,10254,287654.07
2017-11-08,ORL,NYK,18793,46366,17182,43253,2018,3113,1157824.14
2017-11-08,PHX,MIA,13592,31485,12501,29274,1403,2211,601967.59
2017-11-07,CLE,MIL,8646,18574,3264,6112,5583,12462,381476.41
2017-11-07,DEN,BRK,6946,15924,6226,14577,890,1347,362708.73
2017-11-07,IND,NOP,18960,44573,17524,41940,1757,2633,521490.38
2017-11-07,NYK,CHA,22852,59974,20589,54313,3172,5661,1196811.11
2017-11-07,POR,MEM,16864,37416,15704,35084,1522,2332,964419.19
2017-11-07,SAC,OKC,2955,5243,1107,1814,1889,3429,103415.34
2017-11-07,SAS,LAC,17048,35742,15600,32497,1899,3245,743944.53
2017-11-07,TOR,CHI,9215,19436,8383,17848,1018,1588,285754.33
2017-11-07,UTA,PHI,25494,63624,23559,59232,2585,4392,1600555.61
2017-11-07,WAS,DAL,12199,28263,11064,26079,1384,2184,311857.87
2017-11-06,ATL,BOS,44085,121144,39550,110075,6263,11069,1735027.72
2017-11-06,GSW,MIA,37550,98331,33561,88207,5558,10124,1869455.19
2017-11-06,PHX,BRK,16631,37370,15481,34972,1539,2398,441608.7
2017-11-05,CLE,ATL,31383,91731,27537,84254,4605,7477,1195484.25
2017-11-05,HOU,UTA,19455,42278,16655,36464,3310,5814,522241.4
2017-11-05,LAC,MIA,15691,36278,14208,33340,1847,2938,403903.5
2017-11-05,LAL,MEM,29489,90336,26950,83487,3681,6849,1350660.53
2017-11-05,MIN,CHA,12535,26087,11197,23669,1595,2418,388146.02
2017-11-05,NYK,IND,16734,44308,14152,36957,3562,7351,699107.34
2017-11-05,ORL,BOS,28553,78991,25623,71663,3994,7328,1187260.88
2017-11-05,POR,OKC,32190,95348,29502,88968,3696,6380,1397178.45
2017-11-05,SAS,PHX,9984,21709,8835,19346,1390,2363,311658.57
2017-11-05,TOR,WAS,11769,25049,10799,23279,1140,1770,304106.52
2017-11-04,CHI,NOP,14723,33930,13205,31201,1838,2729,341310.3
2017-11-04,DEN,GSW,31725,85685,27281,74240,5841,11445,1167679.13
2017-11-04,DET,SAC,13268,29671,11968,27196,1700,2475,351572.99
2017-11-04,LAC,MEM,11323,24669,9198,21248,2369,3421,321757.5
2017-11-04,MIN,DAL,11250,24024,9602,21234,1945,2790,270988.7
2017-11-03,ATL,HOU,7504,15972,6264,13720,1422,2252,169589.29
2017-11-03,DAL,NOP,6651,14288,5825,12854,960,1434,169583.26
2017-11-03,DEN,MIA,9739,24570,8702,22614,1252,1956,287264.23
2017-11-03,DET,MIL,11903,26631,10111,23417,2123,3214,297743.65
2017-11-03,LAL,BRK,27027,85428,24393,78382,3776,7046,1263424.3
2017-11-03,NYK,PHX,11629,31579,9677,26765,2505,4814,457754.82
2017-11-03,OKC,BOS,6882,13605,1230,2097,5730,11508,261102.62
2017-11-03,ORL,CHI,7359,16836,6199,14722,1352,2114,189495.08
2017-11-03,PHI,IND,19711,54270,17039,48518,3339,5752,672287.06
2017-11-03,SAS,CHA,9061,20978,7800,18229,1531,2749,302774.35
2017-11-03,UTA,TOR,7853,18299,7019,16452,999,1847,259835.89
2017-11-03,WAS,CLE,7901,17639,1195,2071,6768,15568,371485.59
2017-11-02,POR,LAL,32070,111784,29057,105888,3262,5896,796268.86
2017-11-02,SAS,GSW,43830,160645,39461,150657,4843,9988,1189982.09
2017-11-01,BOS,SAC,20406,53676,17777,47585,3320,6091,919028.21
2017-11-01,CHA,MIL,14574,33313,12291,29343,2530,3970,341876.45
2017-11-01,CLE,IND,32246,99779,29091,93109,3841,6670,1213422.26
2017-11-01,DEN,TOR,7209,15763,6451,14312,878,1451,226160.43
2017-11-01,LAC,DAL,842,1311,167,276,678,1035,25324.82
2017-11-01,MEM,ORL,10385,23631,9249,21442,1308,2189,269318.75
2017-11-01,MIA,CHI,9065,23122,8029,21093,1237,2029,319436.94
2017-11-01,NOP,MIN,16773,37720,15017,34356,2052,3364,516669.28
2017-11-01,NYK,HOU,1978,3505,363,640,1630,2865,63930.24
2017-11-01,PHI,ATL,17597,44853,15795,41149,2191,3704,617029.45
2017-11-01,UTA,POR,16260,40073,14905,37007,1683,3066,687796.95
2017-11-01,WAS,PHX,11388,27084,10012,24298,1576,2786,259902.27
2017-10-31,BRK,PHX,17689,41563,15602,37841,2470,3722,636213.81
2017-10-31,IND,SAC,15023,30839,12818,27470,2528,3369,491290.18
2017-10-31,LAL,DET,5846,11259,1605,2700,4367,8559,219091.18
2017-10-31,MIL,OKC,6309,11734,1375,2140,5022,9594,208810.01
2017-10-30,BOS,SAS,7393,13800,1743,3447,5797,10353,246802.64
2017-10-30,HOU,PHI,34070,85297,29797,77458,5045,7839,1508292.74
2017-10-30,LAC,GSW,7555,15661,1884,3321,5814,12340,394948.14
2017-10-30,MEM,CHA,7469,14648,6067,12653,1505,1995,196828.51
2017-10-30,MIA,MIN,28303,72701,25202,66565,3882,6136,1063416.6
2017-10-30,NOP,ORL,9668,20855,7739,18095,2095,2760,323918.7
2017-10-30,NYK,DEN,17432,45321,14635,39863,3410,5458,780174.93
2017-10-30,POR,TOR,15440,31633,14209,29641,1432,1992,845997.57
2017-10-30,UTA,DAL,10412,22188,9086,19814,1583,2374,426563.02
2017-10-29,ATL,MIL,15372,31689,11648,26209,4069,5480,442700.65
2017-10-29,BRK,DEN,8281,17102,6757,14749,1713,2353,228394.07
2017-10-29,CHA,ORL,9882,19836,8156,17308,1897,2528,286422.31
2017-10-29,CLE,NYK,35579,97772,29786,86455,7005,11317,1693481.7
2017-10-29,GSW,DET,40296,109558,34562,98175,7113,11383,2432078.59
2017-10-29,IND,SAS,17707,38039,14571,33257,3517,4782,726833.19
2017-10-29,SAC,WAS,8681,16480,6737,13766,2131,2714,302447.24
2017-10-28,CHI,OKC,18228,43405,14244,36438,4560,6967,606130.07
2017-10-28,DAL,PHI,19951,46748,16548,40288,4056,6460,723261.74
2017-10-28,LAC,DET,12385,25657,10549,22662,2103,2995,612304.46
2017-10-28,MEM,HOU,13402,28314,10832,24565,2831,3749,411251.53
2017-10-28,MIA,BOS,25680,69103,21324,60113,5346,8990,1159010.75
2017-10-28,NOP,CLE,36198,92673,30218,82461,6949,10212,1288954.94
2017-10-28,POR,PHX,12386,26843,10777,24190,1851,2653,518379.21
2017-10-28,UTA,LAL,26613,72020,23056,65446,4293,6574,1084786.71
2017-10-27,ATL,DEN,10452,21276,9208,19216,1396,2060,364289.0
2017-10-27,CHA,HOU,20420,45360,16594,39269,4333,6091,591036.09
2017-10-27,GSW,WAS,10672,21112,2514,4563,8398,16549,431787.46
2017-10-27,LAL,TOR,29768,84759,26031,78051,4619,6708,1810504.56
2017-10-27,MIN,OKC,8378,14033,2186,3945,6295,10088,232358.27
2017-10-27,NYK,BRK,14338,33248,11495,27643,3369,5605,591145.67
2017-10-27,ORL,SAS,15614,32107,12183,26996,3769,5111,491658.2
2017-10-26,CHI,ATL,12965,27160,10510,23527,2759,3633,395421.59
2017-10-26,MEM,DAL,12788,26039,10515,22898,2506,3141,354311.57
2017-10-26,MIL,BOS,41860,143558,36947,134215,5385,9343,1057239.85
2017-10-26,POR,LAC,21740,47459,17982,40659,4445,6800,1128995.58
2017-10-26,SAC,NOP,2880,4137,283,490,2606,3647,58976.1
2017-10-25,BRK,CLE,35875,94602,30932,86120,5705,8482,1759449.2
2017-10-25,CHA,DEN,9358,18360,7087,15251,2447,3109,186707.52
2017-10-25,DAL,MEM,11082,21943,9403,19479,1870,2464,398071.5
2017-10-25,DET,MIN,12083,24145,9440,20370,2909,3775,268098.13
2017-10-25,GSW,TOR,34487,89124,28663,76701,7355,12423,2200702.86
2017-10-25,LAL,WAS,6909,11876,1259,2086,5711,9790,192276.9
2017-10-25,MIA,SAS,2332,3598,217,409,2121,3189,63965.33
2017-10-25,OKC,IND,28090,70317,23546,62036,5375,8281,1365105.55
2017-10-25,PHI,HOU,36084,90580,30356,79905,7033,10675,1340384.06
2017-10-25,PHX,UTA,10881,24289,9124,21607,1997,2682,411290.34
2017-10-24,BOS,NYK,66407,149502,58786,135393,9769,14109,2254331.43
2017-10-24,CLE,CHI,11729,20310,2595,4880,9196,15430,293937.12
2017-10-24,LAC,UTA,45479,96371,40938,88554,5861,7817,1906026.0
2017-10-24,MIN,IND,52182,100502,48052,94213,4878,6289,1327125.96
2017-10-24,ORL,BRK,48506,106771,44007,99339,5524,7432,1117092.76
2017-10-24,POR,NOP,3609,5356,1054,1733,2567,3623,71903.53
2017-10-23,DAL,GSW,66436,165195,57284,146313,11330,18882,2263394.11
2017-10-23,DEN,WAS,34531,68767,31247,63629,3708,5138,1024873.98
2017-10-23,DET,PHI,56883,127919,49099,114726,9364,13193,1623462.97
2017-10-23,HOU,MEM,52659,115969,46429,105347,7369,10622,1263082.76
2017-10-23,MIA,ATL,23894,49195,20816,44460,3609,4735,539539.7
2017-10-23,MIL,CHA,37704,80374,32414,72184,6010,8190,940429.84
2017-10-23,PHX,SAC,34504,69497,30996,63839,4055,5658,1098629.07
2017-10-23,SAS,TOR,5133,8253,141,181,4993,8072,144318.1
2017-10-22,BRK,ATL,25795,60136,20746,52617,5750,7519,491241.93
2017-10-22,LAL,NOP,85827,287412,78403,271528,10878,15884,2524251.33
2017-10-22,OKC,MIN,103575,346322,89909,315836,18821,30486,3005079.76
2017-10-21,CHI,SAS,22950,48295,18712,40927,4980,7368,643378.86
2017-10-21,CLE,ORL,73644,186306,64033,170022,11669,16284,2256956.0
2017-10-21,DEN,SAC,21169,42640,19002,38640,2562,4000,463670.79
2017-10-21,HOU,DAL,27911,55194,22760,47003,5894,8191,653678.05
2017-10-21,LAC,PHX,2324,3106,41,66,2283,3040,40488.39
2017-10-21,MEM,GSW,4711,7506,207,307,4504,7199,153812.45
2017-10-21,MIA,IND,19327,40162,16226,35058,3577,5104,594055.84
2017-10-21,MIL,POR,48049,106310,42126,96678,7098,9632,1041064.75
2017-10-21,NYK,DET,25171,56349,22005,50798,3824,5551,654864.8
2017-10-21,TOR,PHI,49884,98594,43908,88346,7567,10248,1100838.52
2017-10-21,UTA,OKC,79172,195986,71282,181554,10020,14432,2167929.6
2017-10-20,BRK,ORL,22612,42095,19211,37086,3799,5009,372868.33
2017-10-20,CHA,ATL,15953,26662,11180,20250,5070,6412,198106.54
2017-10-20,DAL,SAC,24643,45095,20631,39027,4591,6068,452184.71
2017-10-20,IND,POR,19883,38793,15353,31695,5012,7098,435646.06
2017-10-20,MIL,CLE,12148,20146,374,679,11776,19467,333011.59
2017-10-20,MIN,UTA,42009,86841,35985,76741,7026,10100,1304864.1
2017-10-20,NOP,GSW,8469,13947,69,185,8401,13762,240212.0
2017-10-20,PHI,BOS,75901,191416,64906,170222,13516,21194,2957068.83
2017-10-20,PHX,LAL,94661,270030,80224,235680,19096,34350,3729968.03
2017-10-20,WAS,DET,31381,61140,27256,54604,4855,6536,534772.62
2017-10-19,LAL,LAC,70643,238854,60985,221732,10643,17122,2543123.92
2017-10-19,OKC,NYK,91453,349973,79543,326406,13638,23567,2769203.54
2017-10-19,TOR,CHI,53166,107459,44941,93560,10081,13899,1209773.24
2017-10-18,BOS,MIL,93078,238579,81577,215715,14759,22864,3238477.83
2017-10-18,DAL,ATL,30728,61434,27027,55770,4348,5664,650126.3
2017-10-18,DET,CHA,33008,60904,25817,49630,8231,11274,526215.87
2017-10-18,IND,BRK,32107,66950,25912,57208,7117,9742,644958.57
2017-10-18,MEM,NOP,34025,62159,30047,55942,4617,6217,638274.48
2017-10-18,ORL,MIA,31146,67622,26695,60567,5215,7055,791468.49
2017-10-18,PHX,POR,30751,62292,25708,54076,5943,8216,786973.81
2017-10-18,SAC,HOU,54397,123778,47319,111362,8650,12416,1872907.47
2017-10-18,SAS,MIN,7607,11598,140,293,7467,11305,171328.25
2017-10-18,UTA,DEN,29642,63180,25514,55316,5047,7864,994750.18
2017-10-18,WAS,PHI,8672,13488,228,333,8447,13155,212775.74
2017-10-17,CLE,BOS,134604,676098,117978,641451,18684,34647,4855083.14
2017-10-17,GSW,HOU,97284,391747,79628,356153,19628,35594,4882948.27
2017-10-13,CHA,DAL,33,38,0,0,33,38,55.25
2017-10-13,CHI,TOR,258,389,13,37,245,352,4387.67
2017-10-13,GSW,SAC,736,1328,68,268,668,1060,17162.65
2017-10-13,HOU,SAS,464,720,23,56,441,664,10579.69
2017-10-13,LAC,LAL,624,895,26,61,598,834,11783.41
2017-10-13,MEM,NOP,176,290,10,80,166,210,2116.5
2017-10-13,MIL,DET,227,346,19,50,208,296,5583.83
2017-10-13,NYK,WAS,350,545,17,44,333,501,5737.84
2017-10-13,ORL,CLE,982,1615,73,160,909,1455,11714.18
2017-10-13,PHI,MIA,204,244,0,0,204,244,1204.53
2017-10-13,POR,MAC,45,56,0,0,45,56,67.97
2017-10-12,ATL,DAL,34,41,0,0,34,41,114.32
2017-10-12,LAC,SAC,184,285,11,12,173,273,2578.14
2017-10-11,BRK,PHI,127,175,0,0,127,175,529.77
2017-10-11,CHA,BOS,342,520,16,24,326,496,5732.9
2017-10-11,MEM,HOU,110,161,6,11,104,150,2552.78
2017-10-11,MIA,WAS,113,220,16,67,97,153,1546.46
2017-10-11,PHX,POR,55,71,0,0,55,71,248.37
2017-10-10,CLE,CHI,205,328,6,19,199,309,3380.2
2017-10-10,DEN,OKC,335,699,30,206,305,493,8004.23
2017-10-10,IND,MAC,90,107,5,9,85,98,214.81
2017-10-10,LAL,UTA,167,279,5,7,162,272,4216.51
2017-10-10,SAS,ORL,27,30,0,0,27,30,164.73
2017-10-10,TOR,DET,83,148,1,29,82,119,1596.05
2017-10-09,BOS,PHI,205,575,23,289,182,286,4147.43
2017-10-09,DAL,ORL,50,98,8,36,42,62,548.04
2017-10-09,DET,IND,24,33,0,0,24,33,56.55
2017-10-09,MIA,CHA,53,103,4,26,49,77,1357.98
2017-10-09,NYK,HOU,108,187,6,21,102,166,1304.71
2017-10-09,PHX,UTA,17,18,0,0,17,18,74.04
2017-10-09,SAC,POR,40,62,3,4,37,58,576.74
2017-10-08,BRK,NYK,79,133,6,14,73,119,1296.74
2017-10-08,CHI,NOP,44,102,4,30,40,72,983.08
2017-10-08,LAL,SAC,13,23,0,0,13,23,52.63
2017-10-08,MIN,GSW,485,867,31,54,454,813,14867.07
2017-10-08,WAS,CLE,82,162,6,52,76,110,730.48
2017-10-07,ORL,MIA,83,160,3,12,80,148,1475.35
2017-10-06,CHI,MIL,91,196,11,76,80,120,1632.73
2017-10-06,CLE,IND,103,161,9,17,94,144,1136.81
2017-10-06,DET,ATL,11,12,0,0,11,12,22.54
2017-10-06,OKC,NOP,59,64,0,0,59,64,181.18
2017-10-06,PHI,BOS,219,392,14,50,207,342,5456.36
2017-10-06,UTA,PHX,17,22,0,0,17,22,67.94
2017-10-06,WAS,NYK,58,145,3,16,55,129,802.46
2017-10-05,BRK,MIA,50,119,7,19,43,100,908.39
2017-10-05,GSW,MIN,203,327,11,37,192,290,4329.87
2017-10-05,HOU,SDS,51,59,0,0,51,59,121.61
2017-10-04,CLE,ATL,140,206,4,7,136,199,2004.63
2017-10-04,DAL,CHI,42,65,0,0,42,65,351.95
2017-10-04,MIL,IND,41,70,2,9,39,61,571.41
2017-10-04,PHI,MEM,132,361,10,129,122,232,1680.7
2017-10-04,UTA,MAC,112,155,7,23,105,132,852.8
2017-10-03,NOP,CHI,99,165,8,32,91,133,1829.97
2017-10-03,NYK,BRK,162,313,10,38,152,275,3152.09
2017-10-03,OKC,HOU,13,18,0,0,13,18,15.86
2017-10-02,BOS,CHA,295,501,8,12,287,489,5514.38
2017-10-02,DAL,MIL,106,243,9,61,97,182,851.16
2017-10-02,LAL,DEN,147,275,3,8,144,267,4033.25
2017-10-02,MEM,ORL,65,133,3,41,62,92,838.8
2017-10-02,SAC,SAS,10,10,0,0,10,10,13.01
2017-10-01,MIA,ATL,181,277,5,21,176,256,1871.33
2017-10-01,TOR,LAC,17,18,0,0,17,18,41.66
2017-09-30,GSW,DEN,965,2061,43,485,922,1576,24952.38
2017-09-30,LAL,MIN,36,42,0,0,36,42,65.62
